DriverName,LapNum,Timestamp,LapTime,LapTimeMins,S1,S2,S1Mins,S2Mins
GasCan13,56,1683387667,86122,01:26.122,41406,44716,00:41.406,00:44.716
chachacha,46,1683332126,86240,01:26.240,41573,44667,00:41.573,00:44.667
GasCan13,59,1683387929,86241,01:26.241,41362,44879,00:41.362,00:44.879
chachacha,26,1683237525,86310,01:26.310,41732,44578,00:41.732,00:44.578
GasCan13,24,1683384400,86341,01:26.341,41737,44604,00:41.737,00:44.604
chachacha,64,1683334006,86358,01:26.358,41700,44658,00:41.700,00:44.658
GasCan13,50,1683387116,86361,01:26.361,41513,44848,00:41.513,00:44.848
GasCan13,48,1683386943,86369,01:26.369,41734,44635,00:41.734,00:44.635
chachacha,23,1683235815,86386,01:26.386,41642,44744,00:41.642,00:44.744
chachacha,71,1683368791,86431,01:26.431,41638,44793,00:41.638,00:44.793
GasCan13,32,1683385105,86432,01:26.432,41613,44819,00:41.613,00:44.819
chachacha,63,1683333920,86447,01:26.447,41749,44698,00:41.749,00:44.698
GasCan13,22,1683384223,86471,01:26.471,41696,44775,00:41.696,00:44.775
GasCan13,39,1683385744,86486,01:26.486,41675,44811,00:41.675,00:44.811
chachacha,25,1683237439,86490,01:26.490,41795,44695,00:41.795,00:44.695
GasCan13,42,1683386009,86512,01:26.512,41643,44869,00:41.643,00:44.869
chachacha,19,1683235259,86515,01:26.515,41843,44672,00:41.843,00:44.672
GasCan13,15,1683383517,86554,01:26.554,41667,44887,00:41.667,00:44.887
chachacha,42,1683331751,86559,01:26.559,41685,44874,00:41.685,00:44.874
chachacha,73,1683368967,86580,01:26.580,41764,44816,00:41.764,00:44.816
chachacha,58,1683333341,86631,01:26.631,41820,44811,00:41.820,00:44.811
Yuval Rosen,57,1683207829,86660,01:26.660,41895,44765,00:41.895,00:44.765
chachacha,11,1683234543,86676,01:26.676,42026,44650,00:42.026,00:44.650
GasCan13,30,1683384931,86681,01:26.681,41762,44919,00:41.762,00:44.919
GasCan13,47,1683386856,86719,01:26.719,41642,45077,00:41.642,00:45.077
GasCan13,4,1683382275,86745,01:26.745,41799,44946,00:41.799,00:44.946
Yuval Rosen,68,1683397992,86753,01:26.753,41889,44864,00:41.889,00:44.864
GasCan13,55,1683387581,86755,01:26.755,41643,45112,00:41.643,00:45.112
chachacha,57,1683333254,86758,01:26.758,41835,44923,00:41.835,00:44.923
chachacha,13,1683234721,86764,01:26.764,41957,44807,00:41.957,00:44.807
chachacha,17,1683235081,86774,01:26.774,41613,45161,00:41.613,00:45.161
chachacha,6,1683233920,86775,01:26.775,41928,44847,00:41.928,00:44.847
chachacha,51,1683332720,86787,01:26.787,41831,44956,00:41.831,00:44.956
chachacha,62,1683333834,86795,01:26.795,41894,44901,00:41.894,00:44.901
Dori_N,80,1683385166,86798,01:26.798,42001,44797,00:42.001,00:44.797
GasCan13,10,1683383080,86812,01:26.812,41916,44896,00:41.916,00:44.896
chachacha,69,1683368614,86828,01:26.828,41815,45013,00:41.815,00:45.013
chachacha,54,1683332990,86839,01:26.839,41654,45185,00:41.654,00:45.185
chachacha,59,1683333427,86841,01:26.841,41710,45131,00:41.710,00:45.131
GasCan13,17,1683383693,86867,01:26.867,41638,45229,00:41.638,00:45.229
chachacha,43,1683331838,86894,01:26.894,41634,45260,00:41.634,00:45.260
GasCan13,6,1683382451,86897,01:26.897,41717,45180,00:41.717,00:45.180
Yuval Rosen,66,1683397637,86910,01:26.910,41838,45072,00:41.838,00:45.072
chachacha,5,1683233834,86923,01:26.923,42242,44681,00:42.242,00:44.681
Yuval Rosen,81,1683399143,86925,01:26.925,41704,45221,00:41.704,00:45.221
GasCan13,45,1683386680,86927,01:26.927,41495,45432,00:41.495,00:45.432
GasCan13,14,1683383431,86968,01:26.968,41909,45059,00:41.909,00:45.059
GasCan13,26,1683384575,86975,01:26.975,41777,45198,00:41.777,00:45.198
Yuval Rosen,42,1683149424,86978,01:26.978,41754,45224,00:41.754,00:45.224
Yuval Rosen,77,1683398792,86982,01:26.982,41698,45284,00:41.698,00:45.284
GasCan13,12,1683383255,86995,01:26.995,41802,45193,00:41.802,00:45.193
chachacha,21,1683235552,87007,01:27.007,41849,45158,00:41.849,00:45.158
chachacha,75,1683369143,87011,01:27.011,41778,45233,00:41.778,00:45.233
Yuval Rosen,56,1683207742,87012,01:27.012,41922,45090,00:41.922,00:45.090
yarimalk23,39,1683324400,87014,01:27.014,42033,44981,00:42.033,00:44.981
Yuval Rosen,78,1683398879,87030,01:27.030,41831,45199,00:41.831,00:45.199
Yuval Rosen,24,1683147355,87053,01:27.053,42000,45053,00,00:45.053
Yuval Rosen,31,1683148189,87059,01:27.059,42123,44936,00:42.123,00:44.936
chachacha,33,1683330844,87110,01:27.110,41458,45652,00:41.458,00:45.652
chachacha,78,1683369420,87121,01:27.121,41878,45243,00:41.878,00:45.243
yarimalk23,45,1683324971,87148,01:27.148,41927,45221,00:41.927,00:45.221
Yuval Rosen,25,1683147442,87185,01:27.185,41880,45305,00:41.880,00:45.305
Yuval Rosen,92,1683400150,87198,01:27.198,41775,45423,00:41.775,00:45.423
Yuval Rosen,48,1683149978,87212,01:27.212,41965,45247,00:41.965,00:45.247
Dori_N,68,1683384026,87232,01:27.232,42300,44932,00:42.300,00:44.932
Dori_N,79,1683385079,87236,01:27.236,42227,45009,00:42.227,00:45.009
Yuval Rosen,59,1683397002,87239,01:27.239,42024,45215,00:42.024,00:45.215
chachacha,68,1683368527,87265,01:27.265,42099,45166,00:42.099,00:45.166
Dori_N,75,1683384711,87268,01:27.268,42142,45126,00:42.142,00:45.126
Yuval Rosen,17,1683146662,87273,01:27.273,41949,45324,00:41.949,00:45.324
GasCan13,57,1683387754,87283,01:27.283,41729,45554,00:41.729,00:45.554
chachacha,56,1683333167,87284,01:27.284,41996,45288,00:41.996,00:45.288
Y.Cohen,92,1683389530,87297,01:27.297,42126,45171,00:42.126,00:45.171
chachacha,40,1683331478,87298,01:27.298,42015,45283,00:42.015,00:45.283
Yuval Rosen,4,1683145485,87307,01:27.307,42420,44887,00:42.420,00:44.887
e30misha,44,1683184234,87322,01:27.322,41944,45378,00:41.944,00:45.378
chachacha,49,1683332539,87326,01:27.326,41868,45458,00:41.868,00:45.458
Y.Cohen,104,1683390838,87331,01:27.331,42331,45000,00:42.331,00
Y.Cohen,94,1683389761,87336,01:27.336,42128,45208,00:42.128,00:45.208
Y.Cohen,100,1683390473,87355,01:27.355,42184,45171,00:42.184,00:45.171
chachacha,66,1683368351,87355,01:27.355,42206,45149,00:42.206,00:45.149
yarimalk23,29,1683323455,87366,01:27.366,42122,45244,00:42.122,00:45.244
U.V,43,1683282446,87391,01:27.391,42243,45148,00:42.243,00:45.148
GasCan13,8,1683382814,87419,01:27.419,42136,45283,00:42.136,00:45.283
Dori_N,50,1683371255,87424,01:27.424,42393,45031,00:42.393,00:45.031
Yuval Rosen,63,1683397374,87445,01:27.445,41910,45535,00:41.910,00:45.535
chachacha,3,1683233603,87452,01:27.452,42273,45179,00:42.273,00:45.179
Dori_N,64,1683382481,87458,01:27.458,42342,45116,00:42.342,00:45.116
Y.Cohen,98,1683390112,87460,01:27.460,42280,45180,00:42.280,00:45.180
Yuval Rosen,3,1683145398,87482,01:27.482,42442,45040,00:42.442,00:45.040
chachacha,32,1683330757,87486,01:27.486,41955,45531,00:41.955,00:45.531
GasCan13,49,1683387030,87496,01:27.496,41916,45580,00:41.916,00:45.580
Y.Cohen,87,1683389080,87505,01:27.505,42361,45144,00:42.361,00:45.144
Yuval Rosen,8,1683145844,87513,01:27.513,42283,45230,00:42.283,00:45.230
Dori_N,42,1683370363,87514,01:27.514,42374,45140,00:42.374,00:45.140
yarimalk23,38,1683324313,87518,01:27.518,42208,45310,00:42.208,00:45.310
e30misha,57,1683216505,87521,01:27.521,42125,45396,00:42.125,00:45.396
AryeMorZ,71,1683395671,87522,01:27.522,42161,45361,00:42.161,00:45.361
Y.Cohen,97,1683390024,87527,01:27.527,42307,45220,00:42.307,00:45.220
Yuval Rosen,45,1683149701,87532,01:27.532,42023,45509,00:42.023,00:45.509
Dori_N,45,1683370638,87553,01:27.553,42625,44928,00:42.625,00:44.928
Yuval Rosen,75,1683398615,87568,01:27.568,42154,45414,00:42.154,00:45.414
Y.Cohen,58,1683367792,87573,01:27.573,42410,45163,00:42.410,00:45.163
Y.Cohen,49,1683366525,87576,01:27.576,42463,45113,00:42.463,00:45.113
Y.Cohen,86,1683388992,87587,01:27.587,42367,45220,00:42.367,00:45.220
GasCan13,35,1683385372,87592,01:27.592,41719,45873,00:41.719,00:45.873
Y.Cohen,76,1683387928,87602,01:27.602,42535,45067,00:42.535,00:45.067
Y.Cohen,90,1683389355,87603,01:27.603,42175,45428,00:42.175,00:45.428
U.V,41,1683282268,87604,01:27.604,42311,45293,00:42.311,00:45.293
Y.Cohen,95,1683389848,87615,01:27.615,42416,45199,00:42.416,00:45.199
Yuval Rosen,72,1683398344,87620,01:27.620,41698,45922,00:41.698,00:45.922
Y.Cohen,77,1683388016,87631,01:27.631,42271,45360,00:42.271,00:45.360
Yuval Rosen,65,1683397550,87631,01:27.631,41996,45635,00:41.996,00:45.635
GasCan13,3,1683382188,87650,01:27.650,42133,45517,00:42.133,00:45.517
yarimalk23,24,1683322993,87653,01:27.653,42303,45350,00:42.303,00:45.350
e30misha,56,1683216418,87667,01:27.667,42438,45229,00:42.438,00:45.229
Yuval Rosen,87,1683399683,87668,01:27.668,42093,45575,00:42.093,00:45.575
Y.Cohen,70,1683387399,87669,01:27.669,42336,45333,00:42.336,00:45.333
Yuval Rosen,41,1683149337,87692,01:27.692,41959,45733,00:41.959,00:45.733
Dori_N,73,1683384532,87703,01:27.703,42109,45594,00:42.109,00:45.594
e30misha,37,1683183599,87715,01:27.715,42499,45216,00:42.499,00:45.216
GasCan13,41,1683385923,87729,01:27.729,42310,45419,00:42.310,00:45.419
Y.Cohen,106,1683391014,87738,01:27.738,42342,45396,00:42.342,00:45.396
Yuval Rosen,94,1683400334,87760,01:27.760,42090,45670,00:42.090,00:45.670
Dori_N,40,1683370162,87761,01:27.761,42433,45328,00:42.433,00:45.328
e30misha,43,1683184147,87768,01:27.768,42254,45514,00:42.254,00:45.514
e30misha,48,1683215642,87776,01:27.776,42412,45364,00:42.412,00:45.364
yarimalk23,50,1683325563,87777,01:27.777,42250,45527,00:42.250,00:45.527
Yuval Rosen,83,1683399321,87787,01:27.787,41757,46030,00:41.757,00:46.030
U.V,34,1683278880,87803,01:27.803,42578,45225,00:42.578,00:45.225
GasCan13,2,1683382101,87831,01:27.831,41858,45973,00:41.858,00:45.973
e30misha,47,1683215554,87843,01:27.843,42478,45365,00:42.478,00:45.365
Yuval Rosen,95,1683400422,87850,01:27.850,42017,45833,00:42.017,00:45.833
yarimalk23,19,1683301212,87852,01:27.852,42411,45441,00:42.411,00:45.441
Y.Cohen,91,1683389442,87853,01:27.853,42322,45531,00:42.322,00:45.531
AryeMorZ,69,1683395491,87855,01:27.855,42323,45532,00:42.323,00:45.532
GasCan13,31,1683385019,87865,01:27.865,41969,45896,00:41.969,00:45.896
e30misha,53,1683216118,87872,01:27.872,42409,45463,00:42.409,00:45.463
U.V,11,1683220762,87873,01:27.873,42468,45405,00:42.468,00:45.405
e30misha,60,1683216770,87876,01:27.876,42318,45558,00:42.318,00:45.558
Yuval Rosen,71,1683398257,87877,01:27.877,42080,45797,00:42.080,00:45.797
AryeMorZ,61,1683389074,87879,01:27.879,42217,45662,00:42.217,00:45.662
yarimalk23,22,1683301585,87881,01:27.881,42445,45436,00:42.445,00:45.436
e30misha,23,1683182333,87883,01:27.883,42460,45423,00:42.460,00:45.423
GasCan13,21,1683384136,87885,01:27.885,42592,45293,00:42.592,00:45.293
Y.Cohen,75,1683387840,87892,01:27.892,42536,45356,00:42.536,00:45.356
e30misha,59,1683216683,87894,01:27.894,42290,45604,00:42.290,00:45.604
Yuval Rosen,53,1683207359,87903,01:27.903,42192,45711,00:42.192,00:45.711
Y.Cohen,63,1683386772,87909,01:27.909,42422,45487,00:42.422,00:45.487
e30misha,40,1683183874,87911,01:27.911,42340,45571,00:42.340,00:45.571
assaf_itz,59,1683378058,87917,01:27.917,42319,45598,00:42.319,00:45.598
Dori_N,33,1683369490,87921,01:27.921,42534,45387,00:42.534,00:45.387
Y.Cohen,84,1683388816,87943,01:27.943,42578,45365,00:42.578,00:45.365
Y.Cohen,72,1683387576,87947,01:27.947,42362,45585,00:42.362,00:45.585
Dori_N,24,1683368603,87948,01:27.948,42569,45379,00:42.569,00:45.379
Yuval Rosen,26,1683147530,87950,01:27.950,42366,45584,00:42.366,00:45.584
leviarnon1,42,1683406710,87957,01:27.957,42381,45576,00:42.381,00:45.576
Yuval Rosen,22,1683147167,87957,01:27.957,42228,45729,00:42.228,00:45.729
AryeMorZ,25,1683289222,87961,01:27.961,42444,45517,00:42.444,00:45.517
Y.Cohen,66,1683387037,87968,01:27.968,42595,45373,00:42.595,00:45.373
e30misha,30,1683182960,87971,01:27.971,42468,45503,00:42.468,00:45.503
e30misha,27,1683182686,87986,01:27.986,42410,45576,00:42.410,00:45.576
Y.Cohen,40,1683318476,88000,01,42748,45252,00:42.748,00:45.252
e30misha,22,1683182245,88001,01:28.001,42610,45391,00:42.610,00:45.391
Yuval Rosen,98,1683400699,88002,01:28.002,41782,46220,00:41.782,00:46.220
Y.Cohen,31,1683317507,88006,01:28.006,42615,45391,00:42.615,00:45.391
Yuval Rosen,2,1683145310,88007,01:28.007,42243,45764,00:42.243,00:45.764
Y.Cohen,105,1683390926,88021,01:28.021,42549,45472,00:42.549,00:45.472
Y.Cohen,62,1683386684,88030,01:28.030,42558,45472,00:42.558,00:45.472
Y.Cohen,79,1683388368,88043,01:28.043,42607,45436,00:42.607,00:45.436
U.V,25,1683229280,88046,01:28.046,42430,45616,00:42.430,00:45.616
e30misha,8,1683141402,88061,01:28.061,42467,45594,00:42.467,00:45.594
e30misha,29,1683182872,88069,01:28.069,42579,45490,00:42.579,00:45.490
GasCan13,11,1683383168,88084,01:28.084,42665,45419,00:42.665,00:45.419
TAL S,69,1683404827,88089,01:28.089,42305,45784,00:42.305,00:45.784
Yuval Rosen,39,1683149157,88092,01:28.092,42142,45950,00:42.142,00:45.950
Y.Cohen,56,1683367510,88102,01:28.102,42769,45333,00:42.769,00:45.333
Y.Cohen,30,1683317420,88107,01:28.107,42674,45433,00:42.674,00:45.433
yarimalk23,14,1683300659,88109,01:28.109,42417,45692,00:42.417,00:45.692
Yuval Rosen,9,1683145932,88118,01:28.118,42232,45886,00:42.232,00:45.886
U.V,29,1683230547,88126,01:28.126,42802,45324,00:42.802,00:45.324
Y.Cohen,64,1683386860,88128,01:28.128,42786,45342,00:42.786,00:45.342
Yuval Rosen,32,1683148277,88131,01:28.131,42690,45441,00:42.690,00:45.441
assaf_itz,74,1683379797,88138,01:28.138,42468,45670,00:42.468,00:45.670
Y.Cohen,80,1683388456,88139,01:28.139,42424,45715,00:42.424,00:45.715
Dori_N,60,1683382105,88144,01:28.144,42433,45711,00:42.433,00:45.711
chachacha,52,1683332809,88150,01:28.150,42061,46089,00:42.061,00:46.089
assaf_itz,73,1683379709,88150,01:28.150,42700,45450,00:42.700,00:45.450
Elad Levy,50,1683300978,88155,01:28.155,42687,45468,00:42.687,00:45.468
Yuval Rosen,27,1683147618,88162,01:28.162,42320,45842,00:42.320,00:45.842
TAL S,61,1683403676,88163,01:28.163,42335,45828,00:42.335,00:45.828
Y.Cohen,48,1683366438,88168,01:28.168,42673,45495,00:42.673,00:45.495
Dori_N,19,1683320091,88178,01:28.178,42720,45458,00:42.720,00:45.458
GasCan13,25,1683384488,88179,01:28.179,42729,45450,00:42.729,00:45.450
assaf_itz,78,1683380236,88186,01:28.186,42749,45437,00:42.749,00:45.437
TAL S,77,1683405927,88193,01:28.193,42415,45778,00:42.415,00:45.778
AryeMorZ,58,1683388790,88196,01:28.196,42630,45566,00:42.630,00:45.566
TAL S,33,1683395588,88199,01:28.199,42462,45737,00:42.462,00:45.737
e30misha,16,1683181699,88211,01:28.211,42329,45882,00:42.329,00:45.882
TAL S,48,1683402445,88213,01:28.213,42556,45657,00:42.556,00:45.657
TAL S,34,1683395676,88221,01:28.221,42284,45937,00:42.284,00:45.937
leviarnon1,43,1683406798,88226,01:28.226,42678,45548,00:42.678,00:45.548
U.V,33,1683278793,88227,01:28.227,42713,45514,00:42.713,00:45.514
Elad Levy,45,1683300460,88230,01:28.230,42712,45518,00:42.712,00:45.518
Y.Cohen,113,1683391717,88231,01:28.231,42588,45643,00:42.588,00:45.643
GasCan13,33,1683385193,88238,01:28.238,43112,45126,00:43.112,00:45.126
Y.Cohen,85,1683388905,88242,01:28.242,42576,45666,00:42.576,00:45.666
Elad Levy,74,1683406559,88243,01:28.243,42347,45896,00:42.347,00:45.896
GasCan13,28,1683384753,88246,01:28.246,42350,45896,00:42.350,00:45.896
Y.Cohen,19,1683316323,88247,01:28.247,42608,45639,00:42.608,00:45.639
assaf_itz,64,1683378537,88261,01:28.261,42325,45936,00:42.325,00:45.936
Y.Cohen,74,1683387752,88262,01:28.262,42363,45899,00:42.363,00:45.899
chachacha,2,1683233516,88263,01:28.263,43092,45171,00:43.092,00:45.171
yarimalk23,40,1683324488,88265,01:28.265,42244,46021,00:42.244,00:46.021
e30misha,21,1683182157,88278,01:28.278,42701,45577,00:42.701,00:45.577
Yuval Rosen,62,1683397286,88279,01:28.279,42303,45976,00:42.303,00:45.976
U.V,10,1683220674,88291,01:28.291,42540,45751,00:42.540,00:45.751
e30misha,24,1683182421,88291,01:28.291,42535,45756,00:42.535,00:45.756
chachacha,37,1683331211,88291,01:28.291,41815,46476,00:41.815,00:46.476
Y.Cohen,15,1683315968,88293,01:28.293,42906,45387,00:42.906,00:45.387
U.V,16,1683222086,88299,01:28.299,42552,45747,00:42.552,00:45.747
Yuval Rosen,6,1683145664,88301,01:28.301,42307,45994,00:42.307,00:45.994
e30misha,26,1683182598,88307,01:28.307,42772,45535,00:42.772,00:45.535
Elad Levy,24,1683292058,88315,01:28.315,42509,45806,00:42.509,00:45.806
U.V,39,1683281952,88317,01:28.317,42709,45608,00:42.709,00:45.608
Y.Cohen,46,1683366262,88317,01:28.317,43091,45226,00:43.091,00:45.226
Dori_N,25,1683368692,88317,01:28.317,42686,45631,00:42.686,00:45.631
Yuval Rosen,89,1683399870,88322,01:28.322,42719,45603,00:42.719,00:45.603
Y.Cohen,47,1683366350,88335,01:28.335,42857,45478,00:42.857,00:45.478
Y.Cohen,45,1683366173,88338,01:28.338,43230,45108,00:43.230,00:45.108
Elad Levy,37,1683299364,88339,01:28.339,42686,45653,00:42.686,00:45.653
assaf_itz,60,1683378147,88342,01:28.342,42640,45702,00:42.640,00:45.702
chachacha,16,1683234994,88348,01:28.348,42003,46345,00:42.003,00:46.345
Elad Levy,75,1683406648,88354,01:28.354,42373,45981,00:42.373,00:45.981
U.V,18,1683222268,88355,01:28.355,42662,45693,00:42.662,00:45.693
Y.Cohen,73,1683387664,88356,01:28.356,42478,45878,00:42.478,00:45.878
U.V,5,1683219559,88367,01:28.367,42769,45598,00:42.769,00:45.598
assaf_itz,80,1683380422,88378,01:28.378,42302,46076,00:42.302,00:46.076
chachacha,67,1683368439,88381,01:28.381,42031,46350,00:42.031,00:46.350
Y.Cohen,53,1683366934,88391,01:28.391,43113,45278,00:43.113,00:45.278
Yuval Rosen,80,1683399056,88391,01:28.391,41830,46561,00:41.830,00:46.561
Y.Cohen,81,1683388544,88400,01:28.400,42451,45949,00:42.451,00:45.949
Elad Levy,63,1683405044,88406,01:28.406,42799,45607,00:42.799,00:45.607
leviarnon1,41,1683406622,88413,01:28.413,42566,45847,00:42.566,00:45.847
Y.Cohen,111,1683391471,88414,01:28.414,42541,45873,00:42.541,00:45.873
Ido,80,1683395695,88421,01:28.421,42265,46156,00:42.265,00:46.156
yarimalk23,8,1683300107,88428,01:28.428,42330,46098,00:42.330,00:46.098
Yuval Rosen,69,1683398080,88428,01:28.428,42451,45977,00:42.451,00:45.977
Yuval Rosen,37,1683148864,88431,01:28.431,42175,46256,00:42.175,00:46.256
Elad Levy,36,1683299275,88434,01:28.434,42750,45684,00:42.750,00:45.684
MarkZubarev,19,1683382020,88434,01:28.434,42781,45653,00:42.781,00:45.653
Y.Cohen,36,1683318095,88435,01:28.435,43192,45243,00:43.192,00:45.243
Y.Cohen,20,1683316411,88436,01:28.436,43094,45342,00:43.094,00:45.342
e30misha,25,1683182510,88440,01:28.440,42553,45887,00:42.553,00:45.887
e30misha,6,1683141225,88445,01:28.445,42735,45710,00:42.735,00:45.710
Y.Cohen,23,1683316795,88471,01:28.471,42931,45540,00:42.931,00:45.540
AryeMorZ,24,1683289134,88491,01:28.491,42852,45639,00:42.852,00:45.639
Y.Cohen,50,1683366614,88496,01:28.496,42426,46070,00:42.426,00:46.070
assaf_itz,48,1683376913,88497,01:28.497,42569,45928,00:42.569,00:45.928
GasCan13,16,1683383606,88503,01:28.503,41729,46774,00:41.729,00:46.774
Y.Cohen,96,1683389937,88505,01:28.505,42876,45629,00:42.876,00:45.629
Y.Cohen,27,1683317152,88507,01:28.507,42661,45846,00:42.661,00:45.846
assaf_itz,49,1683377001,88510,01:28.510,42637,45873,00:42.637,00:45.873
assaf_itz,70,1683379444,88513,01:28.513,42537,45976,00:42.537,00:45.976
Yuval Rosen,79,1683398968,88514,01:28.514,41913,46601,00:41.913,00:46.601
Y.Cohen,71,1683387488,88515,01:28.515,42632,45883,00:42.632,00:45.883
Elad Levy,23,1683291970,88520,01:28.520,42827,45693,00:42.827,00:45.693
Elad Levy,43,1683300282,88531,01:28.531,42897,45634,00:42.897,00:45.634
assaf_itz,72,1683379621,88536,01:28.536,42622,45914,00:42.622,00:45.914
Y.Cohen,51,1683366702,88540,01:28.540,42932,45608,00:42.932,00:45.608
Yuval Rosen,70,1683398169,88555,01:28.555,42034,46521,00:42.034,00:46.521
e30misha,45,1683184323,88557,01:28.557,42126,46431,00:42.126,00:46.431
Y.Cohen,44,1683366085,88583,01:28.583,43129,45454,00:43.129,00:45.454
Yuval Rosen,20,1683146990,88589,01:28.589,43211,45378,00:43.211,00:45.378
TAL S,32,1683395500,88593,01:28.593,42585,46008,00:42.585,00:46.008
assaf_itz,62,1683378324,88597,01:28.597,42616,45981,00:42.616,00:45.981
e30misha,31,1683183049,88607,01:28.607,42703,45904,00:42.703,00:45.904
Yuval Rosen,13,1683146298,88607,01:28.607,42752,45855,00:42.752,00:45.855
e30misha,19,1683181976,88609,01:28.609,43046,45563,00:43.046,00:45.563
TAL S,44,1683402066,88610,01:28.610,42495,46115,00:42.495,00:46.115
assaf_itz,32,1683235459,88610,01:28.610,42607,46003,00:42.607,00:46.003
chachacha,36,1683331123,88612,01:28.612,42001,46611,00:42.001,00:46.611
assaf_itz,44,1683376113,88620,01:28.620,42522,46098,00:42.522,00:46.098
assaf_itz,58,1683377970,88636,01:28.636,42830,45806,00:42.830,00:45.806
e30misha,35,1683183416,88638,01:28.638,42566,46072,00:42.566,00:46.072
Y.Cohen,107,1683391102,88641,01:28.641,43002,45639,00:43.002,00:45.639
Elad Levy,71,1683406134,88641,01:28.641,42588,46053,00:42.588,00:46.053
Y.Cohen,28,1683317241,88660,01:28.660,43363,45297,00:43.363,00:45.297
Yuval Rosen,99,1683400788,88668,01:28.668,42196,46472,00:42.196,00:46.472
Yuval Rosen,21,1683147079,88671,01:28.671,42892,45779,00:42.892,00:45.779
Y.Cohen,17,1683316145,88683,01:28.683,42994,45689,00:42.994,00:45.689
assaf_itz,14,1683232877,88685,01:28.685,42686,45999,00:42.686,00:45.999
e30misha,17,1683181788,88689,01:28.689,42613,46076,00:42.613,00:46.076
assaf_itz,71,1683379533,88700,01:28.700,42539,46161,00:42.539,00:46.161
Dori_N,15,1683319691,88702,01:28.702,42852,45850,00:42.852,00:45.850
leviarnon1,25,1683405004,88707,01:28.707,42834,45873,00:42.834,00:45.873
Yuval Rosen,14,1683146387,88707,01:28.707,42096,46611,00:42.096,00:46.611
Y.Cohen,22,1683316707,88714,01:28.714,42791,45923,00:42.791,00:45.923
assaf_itz,42,1683375897,88718,01:28.718,42535,46183,00:42.535,00:46.183
e30misha,12,1683152567,88732,01:28.732,42774,45958,00:42.774,00:45.958
Hublot,19,1683404190,88733,01:28.733,42478,46255,00:42.478,00:46.255
Y.Cohen,16,1683316057,88735,01:28.735,43065,45670,00:43.065,00:45.670
assaf_itz,28,1683234912,88743,01:28.743,42653,46090,00:42.653,00:46.090
Hublot,37,1683406030,88743,01:28.743,42717,46026,00:42.717,00:46.026
Y.Cohen,24,1683316884,88745,01:28.745,42926,45819,00:42.926,00:45.819
assaf_itz,81,1683380511,88746,01:28.746,43048,45698,00:43.048,00:45.698
GasCan13,58,1683387843,88763,01:28.763,41685,47078,00:41.685,00:47.078
assaf_itz,75,1683379886,88763,01:28.763,42666,46097,00:42.666,00:46.097
Y.Cohen,14,1683315880,88766,01:28.766,42974,45792,00:42.974,00:45.792
assaf_itz,56,1683377738,88766,01:28.766,42736,46030,00:42.736,00:46.030
leviarnon1,31,1683405707,88776,01:28.776,43065,45711,00:43.065,00:45.711
Hublot,35,1683405840,88777,01:28.777,42868,45909,00:42.868,00:45.909
IMRACING R16,29,1683406191,88783,01:28.783,42806,45977,00:42.806,00:45.977
Y.Cohen,69,1683387312,88791,01:28.791,43426,45365,00:43.426,00:45.365
assaf_itz,45,1683376202,88794,01:28.794,42538,46256,00:42.538,00:46.256
OmriF,156,1683293865,88800,01:28.800,43039,45761,00:43.039,00:45.761
e30misha,55,1683216330,88802,01:28.802,42601,46201,00:42.601,00:46.201
yarimalk23,52,1683325756,88805,01:28.805,42087,46718,00:42.087,00:46.718
GasCan13,13,1683383344,88813,01:28.813,41765,47048,00:41.765,00:47.048
SirSiriuSoWhy,18,1683300957,88813,01:28.813,43026,45787,00:43.026,00:45.787
assaf_itz,77,1683380147,88818,01:28.818,42827,45991,00:42.827,00:45.991
Ido,86,1683396698,88822,01:28.822,42477,46345,00:42.477,00:46.345
Elad Levy,55,1683301491,88830,01:28.830,42462,46368,00:42.462,00:46.368
Y.Cohen,38,1683318287,88834,01:28.834,43191,45643,00:43.191,00:45.643
Ido,56,1683392368,88838,01:28.838,43213,45625,00:43.213,00:45.625
Crazy,29,1683391757,88843,01:28.843,42704,46139,00:42.704,00:46.139
MarkZubarev,16,1683381753,88845,01:28.845,42971,45874,00:42.971,00:45.874
assaf_itz,50,1683377090,88845,01:28.845,42755,46090,00:42.755,00:46.090
U.V,23,1683229102,88858,01:28.858,42918,45940,00:42.918,00:45.940
Elad Levy,34,1683299089,88864,01:28.864,42959,45905,00:42.959,00:45.905
assaf_itz,17,1683233156,88869,01:28.869,42991,45878,00:42.991,00:45.878
IMRACING R16,9,1683402136,88870,01:28.870,42439,46431,00:42.439,00:46.431
Dori_N,5,1683318462,88871,01:28.871,43345,45526,00:43.345,00:45.526
assaf_itz,26,1683234651,88883,01:28.883,42686,46197,00:42.686,00:46.197
Hublot,28,1683405024,88884,01:28.884,42844,46040,00:42.844,00:46.040
TAL S,55,1683403100,88885,01:28.885,42841,46044,00:42.841,00:46.044
serbansim,41,1683382140,88886,01:28.886,42869,46017,00:42.869,00:46.017
EDF Tomer Gulak,11,1683240370,88892,01:28.892,42813,46079,00:42.813,00:46.079
Crazy,24,1683391266,88897,01:28.897,42822,46075,00:42.822,00:46.075
OmriF,359,1683404701,88897,01:28.897,43226,45671,00:43.226,00:45.671
yarimalk23,10,1683300288,88903,01:28.903,43296,45607,00:43.296,00:45.607
yarin levi,67,1683388462,88905,01:28.905,43023,45882,00:43.023,00:45.882
Y.Cohen,68,1683387223,88906,01:28.906,43411,45495,00:43.411,00:45.495
Yuval Rosen,104,1683401262,88916,01:28.916,42702,46214,00:42.702,00:46.214
U.V,22,1683229013,88918,01:28.918,43032,45886,00:43.032,00:45.886
GasCan13,51,1683387205,88919,01:28.919,43425,45494,00:43.425,00:45.494
Elad Levy,62,1683404955,88920,01:28.920,42808,46112,00:42.808,00:46.112
Dori_N,28,1683368972,88920,01:28.920,42822,46098,00:42.822,00:46.098
assaf_itz,83,1683380703,88922,01:28.922,42491,46431,00:42.491,00:46.431
U.V,4,1683219471,88927,01:28.927,43193,45734,00:43.193,00:45.734
TAL S,24,1683394654,88930,01:28.930,42729,46201,00:42.729,00:46.201
leviarnon1,27,1683405191,88930,01:28.930,42792,46138,00:42.792,00:46.138
assaf_itz,54,1683377560,88934,01:28.934,42845,46089,00:42.845,00:46.089
Y.Cohen,35,1683318007,88936,01:28.936,42959,45977,00:42.959,00:45.977
AryeMorZ,26,1683289311,88944,01:28.944,42423,46521,00:42.423,00:46.521
TAL S,50,1683402631,88946,01:28.946,42768,46178,00:42.768,00:46.178
e30misha,4,1683141047,88961,01:28.961,42594,46367,00:42.594,00:46.367
leviarnon1,37,1683406260,88965,01:28.965,42700,46265,00:42.700,00:46.265
OmriF,236,1683385933,88969,01:28.969,43199,45770,00:43.199,00:45.770
Y.Cohen,26,1683317064,88972,01:28.972,42883,46089,00:42.883,00:46.089
TAL S,38,1683401241,88974,01:28.974,42687,46287,00:42.687,00:46.287
Elad Levy,69,1683405956,88979,01:28.979,42454,46525,00:42.454,00:46.525
Elad Levy,56,1683301580,88982,01:28.982,42763,46219,00:42.763,00:46.219
IMRACING R16,23,1683405655,88993,01:28.993,43007,45986,00:43.007,00:45.986
assaf_itz,9,1683231665,89007,01:29.007,43048,45959,00:43.048,00:45.959
Y.Cohen,34,1683317918,89009,01:29.009,42920,46089,00:42.920,00:46.089
EDF Tomer Gulak,10,1683240281,89010,01:29.010,42866,46144,00:42.866,00:46.144
Elad Levy,32,1683293121,89020,01:29.020,42863,46157,00:42.863,00:46.157
Y.Cohen,110,1683391383,89021,01:29.021,42987,46034,00:42.987,00:46.034
Elad Levy,70,1683406045,89022,01:29.022,42689,46333,00:42.689,00:46.333
IMRACING R16,7,1683401957,89028,01:29.028,42687,46341,00:42.687,00:46.341
Hublot,23,1683404558,89029,01:29.029,42873,46156,00:42.873,00:46.156
AryeMorZ,45,1683387354,89032,01:29.032,42574,46458,00:42.574,00:46.458
AryeMorZ,57,1683388702,89032,01:29.032,42660,46372,00:42.660,00:46.372
OmriF,367,1683405742,89033,01:29.033,43134,45899,00:43.134,00:45.899
TAL S,68,1683404739,89035,01:29.035,42860,46175,00:42.860,00:46.175
assaf_itz,35,1683375125,89035,01:29.035,42892,46143,00:42.892,00:46.143
yarin levi,86,1683392297,89038,01:29.038,43043,45995,00:43.043,00:45.995
e30misha,33,1683183227,89045,01:29.045,42943,46102,00:42.943,00:46.102
serbansim,55,1683392215,89050,01:29.050,43019,46031,00:43.019,00:46.031
IMRACING R16,15,1683402845,89054,01:29.054,43137,45917,00:43.137,00:45.917
assaf_itz,69,1683379355,89057,01:29.057,42716,46341,00:42.716,00:46.341
leviarnon1,18,1683404360,89058,01:29.058,43275,45783,00:43.275,00:45.783
leviarnon1,13,1683403899,89060,01:29.060,43309,45751,00:43.309,00:45.751
Crazy,17,1683390569,89062,01:29.062,43005,46057,00:43.005,00:46.057
A972K,19,1683406410,89069,01:29.069,42958,46111,00:42.958,00:46.111
leviarnon1,11,1683403720,89071,01:29.071,42698,46373,00:42.698,00:46.373
chachacha,38,1683331300,89079,01:29.079,41599,47480,00:41.599,00:47.480
yarimalk23,11,1683300377,89079,01:29.079,42908,46171,00:42.908,00:46.171
assaf_itz,38,1683375456,89084,01:29.084,42635,46449,00:42.635,00:46.449
Elad Levy,49,1683300890,89085,01:29.085,42811,46274,00:42.811,00:46.274
leviarnon1,21,1683404638,89086,01:29.086,42979,46107,00:42.979,00:46.107
Elad Levy,18,1683291298,89093,01:29.093,42888,46205,00:42.888,00:46.205
leviarnon1,34,1683405980,89093,01:29.093,42973,46120,00:42.973,00:46.120
leviarnon1,38,1683406349,89100,01:29.100,43370,45730,00:43.370,00:45.730
leviarnon1,24,1683404915,89102,01:29.102,42869,46233,00:42.869,00:46.233
leviarnon1,5,1683205299,89107,01:29.107,42928,46179,00:42.928,00:46.179
TAL S,75,1683405749,89115,01:29.115,42765,46350,00:42.765,00:46.350
Elad Levy,52,1683301174,89115,01:29.115,42656,46459,00:42.656,00:46.459
OmriF,366,1683405653,89116,01:29.116,43031,46085,00:43.031,00:46.085
serbansim,40,1683382051,89117,01:29.117,42808,46309,00:42.808,00:46.309
Yuval Rosen,64,1683397463,89123,01:29.123,42234,46889,00:42.234,00:46.889
serbansim,44,1683382408,89130,01:29.130,43351,45779,00:43.351,00:45.779
OmriF,110,1683238546,89140,01:29.140,43182,45958,00:43.182,00:45.958
yarin levi,56,1683369489,89141,01:29.141,43098,46043,00:43.098,00:46.043
MarkZubarev,18,1683381932,89145,01:29.145,42804,46341,00:42.804,00:46.341
U.V,13,1683221799,89149,01:29.149,43245,45904,00:43.245,00:45.904
Y.Cohen,89,1683389267,89152,01:29.152,42730,46422,00:42.730,00:46.422
Ido,76,1683395313,89159,01:29.159,43071,46088,00:43.071,00:46.088
AryeMorZ,64,1683392624,89160,01:29.160,42773,46387,00:42.773,00:46.387
assaf_itz,53,1683377471,89164,01:29.164,42530,46634,00:42.530,00:46.634
e30misha,32,1683183138,89166,01:29.166,42789,46377,00:42.789,00:46.377
Ido,71,1683394625,89169,01:29.169,43030,46139,00:43.030,00:46.139
GasCan13,5,1683382364,89171,01:29.171,42318,46853,00:42.318,00:46.853
leviarnon1,23,1683404826,89177,01:29.177,42841,46336,00:42.841,00:46.336
Y.Cohen,5,1683314240,89178,01:29.178,43309,45869,00:43.309,00:45.869
Elad Levy,48,1683300801,89189,01:29.189,42894,46295,00:42.894,00:46.295
TAL S,52,1683402826,89192,01:29.192,42537,46655,00:42.537,00:46.655
Elad Levy,29,1683292809,89197,01:29.197,42887,46310,00:42.887,00:46.310
BrAiT_Man,21,1683294612,89199,01:29.199,43195,46004,00:43.195,00:46.004
Ido,16,1683146436,89204,01:29.204,43097,46107,00:43.097,00:46.107
TAL S,56,1683403189,89205,01:29.205,43143,46062,00:43.143,00:46.062
yarin levi,69,1683388651,89216,01:29.216,43137,46079,00:43.137,00:46.079
chachacha,74,1683369056,89217,01:29.217,42043,47174,00:42.043,00:47.174
Landzer,111,1683365101,89222,01:29.222,43151,46071,00:43.151,00:46.071
serbansim,50,1683391614,89225,01:29.225,43051,46174,00:43.051,00:46.174
U.V,38,1683281864,89226,01:29.226,43208,46018,00:43.208,00:46.018
IMRACING R16,19,1683405099,89228,01:29.228,42942,46286,00:42.942,00:46.286
AryeMorZ,67,1683392916,89229,01:29.229,43311,45918,00:43.311,00:45.918
IMRACING R16,20,1683405188,89229,01:29.229,43023,46206,00:43.023,00:46.206
GasCan13,46,1683386769,89229,01:29.229,43887,45342,00:43.887,00:45.342
OmriF,225,1683384887,89230,01:29.230,43001,46229,00:43.001,00:46.229
Elad Levy,66,1683405654,89244,01:29.244,42849,46395,00:42.849,00:46.395
yarin levi,37,1683365928,89254,01:29.254,43250,46004,00:43.250,00:46.004
Y.Cohen,82,1683388633,89255,01:29.255,42343,46912,00:42.343,00:46.912
OmriF,360,1683404790,89259,01:29.259,43273,45986,00:43.273,00:45.986
Y.Cohen,13,1683315791,89262,01:29.262,43082,46180,00:43.082,00:46.180
OmriF,260,1683388884,89277,01:29.277,43219,46058,00:43.219,00:46.058
OmriF,293,1683395343,89278,01:29.278,43387,45891,00:43.387,00:45.891
leviarnon1,32,1683405796,89279,01:29.279,42884,46395,00:42.884,00:46.395
IMRACING R16,27,1683406013,89283,01:29.283,43252,46031,00:43.252,00:46.031
Ido,67,1683394266,89285,01:29.285,42706,46579,00:42.706,00:46.579
IMRACING R16,25,1683405834,89287,01:29.287,43450,45837,00:43.450,00:45.837
Idan M,29,1683401959,89287,01:29.287,43004,46283,00:43.004,00:46.283
OmriF,328,1683399621,89292,01:29.292,43068,46224,00:43.068,00:46.224
Elad Levy,68,1683405867,89293,01:29.293,43190,46103,00:43.190,00:46.103
e30misha,7,1683141314,89296,01:29.296,42869,46427,00:42.869,00:46.427
assaf_itz,12,1683232663,89299,01:29.299,42944,46355,00:42.944,00:46.355
IMRACING R16,30,1683406281,89308,01:29.308,42683,46625,00:42.683,00:46.625
OneLeg,12,1683322932,89311,01:29.311,42848,46463,00:42.848,00:46.463
Ido,70,1683394536,89314,01:29.314,43036,46278,00:43.036,00:46.278
Dori_N,21,1683368314,89316,01:29.316,43231,46085,00:43.231,00:46.085
EDF Tomer Gulak,7,1683239892,89316,01:29.316,43190,46126,00:43.190,00:46.126
e30misha,58,1683216595,89319,01:29.319,42852,46467,00:42.852,00:46.467
yarin levi,50,1683368887,89323,01:29.323,43054,46269,00:43.054,00:46.269
OmriF,329,1683399710,89325,01:29.325,43082,46243,00:43.082,00:46.243
yarin levi,57,1683369579,89332,01:29.332,42762,46570,00:42.762,00:46.570
OmriF,223,1683384708,89346,01:29.346,43144,46202,00:43.144,00:46.202
Hublot,11,1683403235,89348,01:29.348,43583,45765,00:43.583,00:45.765
OmriF,234,1683385754,89353,01:29.353,43345,46008,00:43.345,00:46.008
e30misha,52,1683216030,89356,01:29.356,42389,46967,00:42.389,00:46.967
Yuval Rosen,86,1683399595,89358,01:29.358,42378,46980,00:42.378,00:46.980
OmriF,301,1683396099,89361,01:29.361,43515,45846,00:43.515,00:45.846
Hublot,33,1683405658,89361,01:29.361,43164,46197,00:43.164,00:46.197
OmriF,217,1683383898,89363,01:29.363,43311,46052,00:43.311,00:46.052
MarkZubarev,23,1683382378,89364,01:29.364,42905,46459,00:42.905,00:46.459
MarkZubarev,20,1683382110,89369,01:29.369,43344,46025,00:43.344,00:46.025
AryeMorZ,41,1683386964,89370,01:29.370,42880,46490,00:42.880,00:46.490
OmriF,375,1683406518,89376,01:29.376,43592,45784,00:43.592,00:45.784
OneLeg,7,1683322011,89377,01:29.377,43207,46170,00:43.207,00:46.170
serbansim,43,1683382319,89378,01:29.378,43038,46340,00:43.038,00:46.340
assaf_itz,7,1683231487,89384,01:29.384,43201,46183,00:43.201,00:46.183
OmriF,291,1683395163,89385,01:29.385,43678,45707,00:43.678,00:45.707
Idan M,15,1683395886,89395,01:29.395,42842,46553,00:42.842,00:46.553
IMRACING R16,28,1683406103,89396,01:29.396,42830,46566,00:42.830,00:46.566
yarin levi,24,1683364404,89396,01:29.396,42857,46539,00:42.857,00:46.539
OmriF,207,1683381447,89398,01:29.398,43134,46264,00:43.134,00:46.264
GasCan13,36,1683385461,89398,01:29.398,43313,46085,00:43.313,00:46.085
TAL S,25,1683394744,89403,01:29.403,42778,46625,00:42.778,00:46.625
e30misha,5,1683141137,89408,01:29.408,43427,45981,00:43.427,00:45.981
AryeMorZ,33,1683290091,89412,01:29.412,42873,46539,00:42.873,00:46.539
assaf_itz,16,1683233067,89414,01:29.414,42749,46665,00:42.749,00:46.665
OmriF,282,1683393630,89416,01:29.416,43719,45697,00:43.719,00:45.697
MarkZubarev,22,1683382288,89417,01:29.417,43050,46367,00:43.050,00:46.367
yarin levi,89,1683392566,89417,01:29.417,43175,46242,00:43.175,00:46.242
U.V,27,1683230327,89423,01:29.423,42934,46489,00:42.934,00:46.489
Y.Cohen,18,1683316235,89423,01:29.423,43325,46098,00:43.325,00:46.098
e30misha,62,1683216956,89427,01:29.427,42982,46445,00:42.982,00:46.445
serbansim,42,1683382229,89427,01:29.427,43072,46355,00:43.072,00:46.355
Yuval Rosen,36,1683148775,89428,01:29.428,42759,46669,00:42.759,00:46.669
assaf_itz,61,1683378236,89434,01:29.434,42765,46669,00:42.765,00:46.669
OmriF,109,1683238457,89439,01:29.439,43093,46346,00:43.093,00:46.346
OmriF,376,1683406608,89442,01:29.442,42902,46540,00:42.902,00:46.540
BrAiT_Man,18,1683294320,89442,01:29.442,43343,46099,00:43.343,00:46.099
serbansim,47,1683391338,89442,01:29.442,43510,45932,00:43.510,00:45.932
U.V,30,1683230637,89443,01:29.443,43070,46373,00:43.070,00:46.373
MarkZubarev,21,1683382199,89444,01:29.444,43463,45981,00:43.463,00:45.981
OmriF,226,1683384976,89447,01:29.447,43525,45922,00:43.525,00:45.922
AryeMorZ,39,1683386783,89457,01:29.457,42881,46576,00:42.881,00:46.576
A972K,23,1683406780,89458,01:29.458,43203,46255,00:43.203,00:46.255
Idan M,6,1683394573,89459,01:29.459,43073,46386,00:43.073,00:46.386
OmriF,244,1683387261,89461,01:29.461,43300,46161,00:43.300,00:46.161
Crazy,14,1683390186,89465,01:29.465,43197,46268,00:43.197,00:46.268
Ido,64,1683393471,89469,01:29.469,43213,46256,00:43.213,00:46.256
AryeMorZ,36,1683290368,89470,01:29.470,42805,46665,00:42.805,00:46.665
Ido,40,1683389604,89476,01:29.476,43481,45995,00:43.481,00:45.995
MarkZubarev,17,1683381843,89478,01:29.478,43641,45837,00:43.641,00:45.837
assaf_itz,8,1683231576,89494,01:29.494,42932,46562,00:42.932,00:46.562
TAL S,40,1683401481,89503,01:29.503,43013,46490,00:43.013,00:46.490
OmriF,287,1683394768,89508,01:29.508,43202,46306,00:43.202,00:46.306
chachacha,72,1683368880,89511,01:29.511,41973,47538,00:41.973,00:47.538
Landzer,78,1683305907,89518,01:29.518,43514,46004,00:43.514,00:46.004
yarin levi,16,1683314526,89520,01:29.520,43187,46333,00:43.187,00:46.333
serbansim,49,1683391525,89520,01:29.520,43417,46103,00:43.417,00:46.103
Yuval Rosen,84,1683399411,89520,01:29.520,42611,46909,00:42.611,00:46.909
A972K,14,1683405959,89522,01:29.522,43330,46192,00:43.330,00:46.192
Ido,28,1683148483,89526,01:29.526,43018,46508,00:43.018,00:46.508
Ido,74,1683395102,89527,01:29.527,42835,46692,00:42.835,00:46.692
OmriF,250,1683387906,89528,01:29.528,43116,46412,00:43.116,00:46.412
TAL S,31,1683395411,89530,01:29.530,42631,46899,00:42.631,00:46.899
Landzer,105,1683364550,89531,01:29.531,43091,46440,00:43.091,00:46.440
OmriF,224,1683384797,89532,01:29.532,43393,46139,00:43.393,00:46.139
itziksamurai1,19,1683375420,89534,01:29.534,43463,46071,00:43.463,00:46.071
OmriF,298,1683395827,89540,01:29.540,43290,46250,00:43.290,00:46.250
OmriF,305,1683396475,89543,01:29.543,43292,46251,00:43.292,00:46.251
Elad Levy,54,1683301402,89544,01:29.544,42977,46567,00:42.977,00:46.567
leviarnon1,28,1683405280,89547,01:29.547,43026,46521,00:43.026,00:46.521
TAL S,28,1683395049,89549,01:29.549,43217,46332,00:43.217,00:46.332
yarin levi,49,1683368797,89552,01:29.552,43472,46080,00:43.472,00:46.080
assaf_itz,39,1683375546,89557,01:29.557,43023,46534,00:43.023,00:46.534
yarimalk23,36,1683324129,89560,01:29.560,42350,47210,00:42.350,00:47.210
yarimalk23,44,1683324883,89563,01:29.563,42722,46841,00:42.722,00:46.841
Crazy,18,1683390659,89564,01:29.564,42787,46777,00:42.787,00:46.777
OmriF,348,1683403148,89564,01:29.564,43624,45940,00:43.624,00:45.940
SirSiriuSoWhy,17,1683300869,89566,01:29.566,43500,46066,00:43.500,00:46.066
serbansim,27,1683365598,89576,01:29.576,43263,46313,00:43.263,00:46.313
Landzer,119,1683365909,89579,01:29.579,43400,46179,00:43.400,00:46.179
Hublot,25,1683404742,89579,01:29.579,43311,46268,00:43.311,00:46.268
MarkZubarev,6,1683379199,89580,01:29.580,43229,46351,00:43.229,00:46.351
Dori_N,4,1683318373,89584,01:29.584,43149,46435,00:43.149,00:46.435
T.K,4,1683359772,89585,01:29.585,43114,46471,00:43.114,00:46.471
OmriF,124,1683240443,89586,01:29.586,42993,46593,00:42.993,00:46.593
Landzer,108,1683364821,89590,01:29.590,43294,46296,00:43.294,00:46.296
OmriF,248,1683387695,89590,01:29.590,43209,46381,00:43.209,00:46.381
Hublot,14,1683403516,89592,01:29.592,42728,46864,00:42.728,00:46.864
A972K,18,1683406321,89596,01:29.596,43151,46445,00:43.151,00:46.445
IMRACING R16,6,1683401868,89598,01:29.598,42950,46648,00:42.950,00:46.648
AryeMorZ,35,1683290278,89599,01:29.599,42795,46804,00:42.795,00:46.804
Ido,35,1683149620,89601,01:29.601,43556,46045,00:43.556,00:46.045
yarimalk23,27,1683323276,89605,01:29.605,42049,47556,00:42.049,00:47.556
MarkZubarev,7,1683379289,89608,01:29.608,43272,46336,00:43.272,00:46.336
yarin levi,78,1683389700,89608,01:29.608,43425,46183,00:43.425,00:46.183
Ido,17,1683146526,89611,01:29.611,43477,46134,00:43.477,00:46.134
yarimalk23,3,1683299508,89611,01:29.611,43495,46116,00:43.495,00:46.116
tomerventura,24,1683393540,89614,01:29.614,43372,46242,00:43.372,00:46.242
yarin levi,47,1683367095,89614,01:29.614,43224,46390,00:43.224,00:46.390
Y.Cohen,3,1683314024,89616,01:29.616,43166,46450,00:43.166,00:46.450
yarin levi,80,1683389879,89620,01:29.620,42865,46755,00:42.865,00:46.755
Y.Cohen,65,1683386949,89621,01:29.621,42938,46683,00:42.938,00:46.683
TAL S,15,1683317912,89623,01:29.623,42872,46751,00:42.872,00:46.751
Dori_N,58,1683372013,89623,01:29.623,42342,47281,00:42.342,00:47.281
U.V,2,1683219292,89627,01:29.627,43547,46080,00:43.547,00:46.080
Ido,58,1683392853,89631,01:29.631,43226,46405,00:43.226,00:46.405
IMRACING R16,24,1683405744,89636,01:29.636,43165,46471,00:43.165,00:46.471
BrAiT_Man,20,1683294523,89637,01:29.637,43008,46629,00:43.008,00:46.629
OmriF,133,1683241616,89638,01:29.638,43423,46215,00:43.423,00:46.215
Yoni Goldberg,26,1683229745,89646,01:29.646,42958,46688,00:42.958,00:46.688
U.V,8,1683219930,89648,01:29.648,43110,46538,00:43.110,00:46.538
Elad Levy,9,1683290089,89649,01:29.649,43253,46396,00:43.253,00:46.396
AryeMorZ,66,1683392826,89654,01:29.654,43421,46233,00:43.421,00:46.233
OmriF,212,1683382147,89654,01:29.654,43502,46152,00:43.502,00:46.152
OmriF,229,1683385270,89656,01:29.656,43193,46463,00:43.193,00:46.463
Idan M,39,1683403742,89658,01:29.658,43154,46504,00:43.154,00:46.504
A972K,7,1683405091,89663,01:29.663,42989,46674,00:42.989,00:46.674
Landzer,104,1683364460,89664,01:29.664,43242,46422,00:43.242,00:46.422
OmriF,372,1683406237,89665,01:29.665,43031,46634,00:43.031,00:46.634
Hublot,38,1683406120,89666,01:29.666,43092,46574,00:43.092,00:46.574
OmriF,274,1683392378,89669,01:29.669,43139,46530,00:43.139,00:46.530
OmriF,300,1683396010,89670,01:29.670,43450,46220,00:43.450,00:46.220
e30misha,41,1683183963,89674,01:29.674,42649,47025,00:42.649,00:47.025
GasCan13,27,1683384664,89674,01:29.674,41915,47759,00:41.915,00:47.759
itziksamurai1,14,1683374802,89674,01:29.674,43076,46598,00:43.076,00:46.598
TAL S,76,1683405839,89675,01:29.675,42516,47159,00:42.516,00:47.159
OmriF,116,1683239145,89675,01:29.675,43172,46503,00:43.172,00:46.503
Y.Cohen,54,1683367024,89679,01:29.679,42699,46980,00:42.699,00:46.980
leviarnon1,15,1683404079,89685,01:29.685,43289,46396,00:43.289,00:46.396
TAL S,14,1683317822,89686,01:29.686,43273,46413,00:43.273,00:46.413
BrAiT_Man,17,1683294230,89691,01:29.691,43475,46216,00:43.475,00:46.216
Crazy,27,1683391537,89692,01:29.692,43036,46656,00:43.036,00:46.656
Dori_N,61,1683382195,89695,01:29.695,42395,47300,00:42.395,00:47.300
Dori_N,83,1683385454,89701,01:29.701,42176,47525,00:42.176,00:47.525
OmriF,144,1683292686,89705,01:29.705,43320,46385,00:43.320,00:46.385
MarkZubarev,15,1683381664,89710,01:29.710,43522,46188,00:43.522,00:46.188
assaf_itz,4,1683231081,89717,01:29.717,43143,46574,00:43.143,00:46.574
Crazy,25,1683391356,89718,01:29.718,43102,46616,00:43.102,00:46.616
Hublot,27,1683404935,89721,01:29.721,43344,46377,00:43.344,00:46.377
Ido,68,1683394356,89723,01:29.723,43112,46611,00:43.112,00:46.611
Landzer,110,1683365012,89725,01:29.725,43344,46381,00:43.344,00:46.381
U.V,24,1683229192,89727,01:29.727,42927,46800,00:42.927,00:46.800
GasCan13,44,1683386593,89731,01:29.731,43341,46390,00:43.341,00:46.390
assaf_itz,55,1683377649,89733,01:29.733,42762,46971,00:42.762,00:46.971
yarin levi,87,1683392386,89736,01:29.736,43282,46454,00:43.282,00:46.454
OmriF,266,1683389470,89740,01:29.740,43431,46309,00:43.431,00:46.309
Hublot,41,1683406557,89744,01:29.744,43880,45864,00:43.880,00:45.864
Landzer,112,1683365191,89751,01:29.751,43113,46638,00:43.113,00:46.638
yarimalk23,32,1683323743,89751,01:29.751,42059,47692,00:42.059,00:47.692
OmriF,120,1683239562,89754,01:29.754,43097,46657,00:43.097,00:46.657
OneLeg,17,1683323413,89755,01:29.755,43747,46008,00:43.747,00:46.008
yarin levi,36,1683365839,89755,01:29.755,42977,46778,00:42.977,00:46.778
A972K,16,1683406139,89761,01:29.761,43191,46570,00:43.191,00:46.570
avieinav,12,1683403463,89761,01:29.761,43352,46409,00:43.352,00:46.409
itziksamurai1,16,1683375128,89764,01:29.764,42676,47088,00:42.676,00:47.088
serbansim,39,1683381962,89766,01:29.766,43731,46035,00:43.731,00:46.035
Hublot,12,1683403325,89773,01:29.773,43266,46507,00:43.266,00:46.507
OmriF,67,1683150243,89775,01:29.775,43478,46297,00:43.478,00:46.297
OmriF,150,1683293283,89778,01:29.778,43571,46207,00:43.571,00:46.207
OmriF,117,1683239235,89786,01:29.786,43171,46615,00:43.171,00:46.615
OmriF,351,1683403581,89786,01:29.786,43590,46196,00:43.590,00:46.196
Elad Levy,44,1683300371,89789,01:29.789,42630,47159,00:42.630,00:47.159
chachacha,60,1683333517,89793,01:29.793,42111,47682,00:42.111,00:47.682
Landzer,106,1683364639,89795,01:29.795,43315,46480,00:43.315,00:46.480
OmriF,113,1683238820,89795,01:29.795,43167,46628,00:43.167,00:46.628
MarkZubarev,11,1683381304,89796,01:29.796,43149,46647,00:43.149,00:46.647
tomerventura,19,1683393070,89797,01:29.797,43357,46440,00:43.357,00:46.440
Landzer,103,1683364370,89800,01:29.800,43338,46462,00:43.338,00:46.462
yarimalk23,26,1683323187,89800,01:29.800,44309,45491,00:44.309,00:45.491
Landzer,118,1683365820,89801,01:29.801,43015,46786,00:43.015,00:46.786
TAL S,65,1683404166,89802,01:29.802,43483,46319,00:43.483,00:46.319
Idan M,28,1683401870,89804,01:29.804,43383,46421,00:43.383,00:46.421
Elad Levy,58,1683404529,89805,01:29.805,43198,46607,00:43.198,00:46.607
OmriF,145,1683292776,89805,01:29.805,43909,45896,00:43.909,00:45.896
yarin levi,66,1683388373,89807,01:29.807,43143,46664,00:43.143,00:46.664
SirSiriuSoWhy,15,1683300689,89807,01:29.807,43278,46529,00:43.278,00:46.529
TAL S,18,1683318190,89811,01:29.811,43271,46540,00:43.271,00:46.540
Idan M,16,1683395976,89812,01:29.812,42999,46813,00:42.999,00:46.813
Dori_N,53,1683371529,89814,01:29.814,42419,47395,00:42.419,00:47.395
yarin levi,38,1683366018,89817,01:29.817,43277,46540,00:43.277,00:46.540
yarin levi,81,1683389969,89817,01:29.817,42733,47084,00:42.733,00:47.084
OmriF,184,1683301818,89823,01:29.823,43333,46490,00:43.333,00:46.490
TAL S,37,1683401152,89826,01:29.826,42809,47017,00:42.809,00:47.017
SirSiriuSoWhy,21,1683366458,89826,01:29.826,43809,46017,00:43.809,00:46.017
Landzer,98,1683363912,89827,01:29.827,43288,46539,00:43.288,00:46.539
Landzer,84,1683306474,89829,01:29.829,43415,46414,00:43.415,00:46.414
GasCan13,43,1683386099,89830,01:29.830,43260,46570,00:43.260,00:46.570
yarin levi,76,1683389512,89831,01:29.831,43148,46683,00:43.148,00:46.683
yarin levi,46,1683367005,89833,01:29.833,43312,46521,00:43.312,00:46.521
serbansim,61,1683392790,89835,01:29.835,43458,46377,00:43.458,00:46.377
OmriF,97,1683237097,89837,01:29.837,43020,46817,00:43.020,00:46.817
OmriF,369,1683405926,89839,01:29.839,43345,46494,00:43.345,00:46.494
SirSiriuSoWhy,28,1683367638,89840,01:29.840,43158,46682,00:43.158,00:46.682
Elad Levy,20,1683291593,89842,01:29.842,43199,46643,00:43.199,00:46.643
OmriF,352,1683403671,89845,01:29.845,43126,46719,00:43.126,00:46.719
chachacha,55,1683333080,89852,01:29.852,42728,47124,00:42.728,00:47.124
OmriF,102,1683237770,89858,01:29.858,43558,46300,00:43.558,00:46.300
chachacha,76,1683369233,89859,01:29.859,41807,48052,00:41.807,00:48.052
IMRACING R16,11,1683402410,89861,01:29.861,43579,46282,00:43.579,00:46.282
Ido,30,1683148732,89862,01:29.862,43314,46548,00:43.314,00:46.548
yarin levi,45,1683366915,89862,01:29.862,42863,46999,00:42.863,00:46.999
GasCan13,7,1683382727,89867,01:29.867,44616,45251,00:44.616,00:45.251
Idan M,32,1683402411,89879,01:29.879,43691,46188,00:43.691,00:46.188
Elad Levy,60,1683404709,89881,01:29.881,43428,46453,00:43.428,00:46.453
OneLeg,5,1683321804,89887,01:29.887,43177,46710,00:43.177,00:46.710
Ori Arish,16,1683148444,89890,01:29.890,42906,46984,00:42.906,00:46.984
Landzer,113,1683365281,89896,01:29.896,43226,46670,00:43.226,00:46.670
EDF Tomer Gulak,2,1683227981,89897,01:29.897,43147,46750,00:43.147,00:46.750
e30misha,10,1683141896,89901,01:29.901,42939,46962,00:42.939,00:46.962
yarimalk23,20,1683301302,89901,01:29.901,42124,47777,00:42.124,00:47.777
Ido,15,1683146347,89902,01:29.902,43241,46661,00:43.241,00:46.661
MarkZubarev,14,1683381575,89903,01:29.903,43356,46547,00:43.356,00:46.547
avieinav,11,1683403373,89907,01:29.907,43349,46558,00:43.349,00:46.558
Hublot,21,1683404371,89916,01:29.916,43053,46863,00:43.053,00:46.863
TAL S,29,1683395139,89917,01:29.917,43653,46264,00:43.653,00:46.264
A972K,6,1683405001,89917,01:29.917,43212,46705,00:43.212,00:46.705
leviarnon1,12,1683403810,89920,01:29.920,43102,46818,00:43.102,00:46.818
BrAiT_Man,10,1683291850,89932,01:29.932,43330,46602,00:43.330,00:46.602
Dori_N,17,1683319909,89933,01:29.933,43673,46260,00:43.673,00:46.260
yarin levi,28,1683364787,89936,01:29.936,43186,46750,00:43.186,00:46.750
itziksamurai1,8,1683208723,89942,01:29.942,43565,46377,00:43.565,00:46.377
OmriF,325,1683399242,89950,01:29.950,43780,46170,00:43.780,00:46.170
OmriF,161,1683294671,89953,01:29.953,43432,46521,00:43.432,00:46.521
Idan M,36,1683403067,89955,01:29.955,42965,46990,00:42.965,00:46.990
U.V,3,1683219382,89957,01:29.957,43797,46160,00:43.797,00:46.160
Dori_N,72,1683384444,89957,01:29.957,42968,46989,00:42.968,00:46.989
OmriF,303,1683396280,89959,01:29.959,43424,46535,00:43.424,00:46.535
OmriF,209,1683381874,89962,01:29.962,43585,46377,00:43.585,00:46.377
OmriF,240,1683386881,89964,01:29.964,43654,46310,00:43.654,00:46.310
Ido,60,1683393038,89973,01:29.973,43672,46301,00:43.672,00:46.301
OmriF,258,1683388701,89974,01:29.974,44060,45914,00:44.060,00:45.914
OmriF,213,1683382237,89976,01:29.976,43400,46576,00:43.400,00:46.576
OmriF,252,1683388094,89980,01:29.980,43212,46768,00:43.212,00:46.768
Ido,26,1683148303,89981,01:29.981,43830,46151,00:43.830,00:46.151
Y.Cohen,109,1683391294,89981,01:29.981,44126,45855,00:44.126,00:45.855
OmriF,313,1683397689,89985,01:29.985,42874,47111,00:42.874,00:47.111
Ori Arish,9,1683147253,89989,01:29.989,43401,46588,00:43.401,00:46.588
OmriF,105,1683238048,89993,01:29.993,43769,46224,00:43.769,00:46.224
Y.Cohen,29,1683317331,90001,01:30.001,43007,46994,00:43.007,00:46.994
Landzer,115,1683365462,90008,01:30.008,43676,46332,00:43.676,00:46.332
Y.Cohen,9,1683315245,90009,01:30.009,43816,46193,00:43.816,00:46.193
OmriF,92,1683236644,90022,01:30.022,43676,46346,00:43.676,00:46.346
OmriF,263,1683389165,90023,01:30.023,43984,46039,00:43.984,00:46.039
Dori_N,69,1683384116,90023,01:30.023,42346,47677,00:42.346,00:47.677
avieinav,6,1683402849,90029,01:30.029,43360,46669,00:43.360,00:46.669
BrAiT_Man,7,1683291575,90029,01:30.029,43310,46719,00:43.310,00:46.719
OmriF,347,1683403058,90034,01:30.034,43364,46670,00:43.364,00:46.670
OmriF,206,1683381357,90040,01:30.040,43515,46525,00:43.515,00:46.525
OmriF,245,1683387351,90041,01:30.041,43916,46125,00:43.916,00:46.125
e30misha,14,1683181193,90045,01:30.045,44113,45932,00:44.113,00:45.932
e30misha,3,1683140958,90049,01:30.049,43222,46827,00:43.222,00:46.827
Ido,37,1683389325,90053,01:30.053,43298,46755,00:43.298,00:46.755
Yuval Rosen,33,1683148367,90054,01:30.054,43848,46206,00:43.848,00:46.206
OmriF,336,1683400794,90057,01:30.057,43716,46341,00:43.716,00:46.341
Elad Levy,7,1683289875,90063,01:30.063,43353,46710,00:43.353,00:46.710
OmriF,341,1683401257,90063,01:30.063,43492,46571,00:43.492,00:46.571
Landzer,123,1683366297,90068,01:30.068,43615,46453,00:43.615,00:46.453
AryeMorZ,76,1683399632,90084,01:30.084,43284,46800,00:43.284,00:46.800
Ido,66,1683394177,90088,01:30.088,43495,46593,00:43.495,00:46.593
OmriF,197,1683380223,90093,01:30.093,43491,46602,00:43.491,00:46.602
OmriF,235,1683385844,90096,01:30.096,43746,46350,00:43.746,00:46.350
serbansim,30,1683377817,90100,01:30.100,43696,46404,00:43.696,00:46.404
Ido,51,1683391369,90101,01:30.101,43216,46885,00:43.216,00:46.885
OmriF,96,1683237007,90108,01:30.108,43568,46540,00:43.568,00:46.540
Yuval Rosen,28,1683147708,90109,01:30.109,42157,47952,00:42.157,00:47.952
OmriF,334,1683400263,90117,01:30.117,43551,46566,00:43.551,00:46.566
chachacha,8,1683234177,90117,01:30.117,42741,47376,00:42.741,00:47.376
OmriF,154,1683293673,90118,01:30.118,43827,46291,00:43.827,00:46.291
OmriF,257,1683388611,90118,01:30.118,43539,46579,00:43.539,00:46.579
Elad Levy,40,1683299733,90119,01:30.119,44391,45728,00:44.391,00:45.728
serbansim,36,1683381691,90126,01:30.126,43479,46647,00:43.479,00:46.647
serbansim,56,1683392305,90127,01:30.127,43709,46418,00:43.709,00:46.418
Landzer,117,1683365730,90135,01:30.135,43749,46386,00:43.749,00:46.386
serbansim,20,1683287619,90137,01:30.137,43243,46894,00:43.243,00:46.894
leviarnon1,19,1683404450,90139,01:30.139,43173,46966,00:43.173,00:46.966
Elad Levy,16,1683291111,90143,01:30.143,43577,46566,00:43.577,00:46.566
Elad Levy,59,1683404619,90143,01:30.143,43479,46664,00:43.479,00:46.664
leviarnon1,36,1683406171,90144,01:30.144,43564,46580,00:43.564,00:46.580
OmriF,340,1683401167,90153,01:30.153,43785,46368,00:43.785,00:46.368
SirSiriuSoWhy,10,1683299607,90153,01:30.153,43636,46517,00:43.636,00:46.517
Ido,34,1683149530,90166,01:30.166,43668,46498,00:43.668,00:46.498
serbansim,26,1683365509,90168,01:30.168,43291,46877,00:43.291,00:46.877
assaf_itz,3,1683230991,90169,01:30.169,43383,46786,00:43.383,00:46.786
Ido,47,1683390701,90184,01:30.184,43370,46814,00:43.370,00:46.814
Hublot,15,1683403606,90184,01:30.184,43533,46651,00:43.533,00:46.651
OmriF,31,1683145882,90187,01:30.187,43860,46327,00:43.860,00:46.327
IMRACING R16,8,1683402047,90189,01:30.189,42858,47331,00:42.858,00:47.331
avieinav,14,1683403644,90189,01:30.189,43740,46449,00:43.740,00:46.449
Ido,22,1683147478,90190,01:30.190,43786,46404,00:43.786,00:46.404
OmriF,66,1683150153,90192,01:30.192,43518,46674,00:43.518,00:46.674
TAL S,9,1683317322,90196,01:30.196,43122,47074,00:43.122,00:47.074
serbansim,16,1683287247,90196,01:30.196,43625,46571,00:43.625,00:46.571
OmriF,214,1683382327,90197,01:30.197,43699,46498,00:43.699,00:46.498
OmriF,233,1683385665,90199,01:30.199,43844,46355,00:43.844,00:46.355
A972K,15,1683406049,90201,01:30.201,43513,46688,00:43.513,00:46.688
SirSiriuSoWhy,25,1683366966,90207,01:30.207,43623,46584,00:43.623,00:46.584
itziksamurai1,6,1683208159,90211,01:30.211,43411,46800,00:43.411,00:46.800
serbansim,18,1683287428,90215,01:30.215,43640,46575,00:43.640,00:46.575
Yuval Rosen,19,1683146902,90215,01:30.215,42376,47839,00:42.376,00:47.839
Ido,52,1683391459,90218,01:30.218,43599,46619,00:43.599,00:46.619
A972K,21,1683406592,90218,01:30.218,43472,46746,00:43.472,00:46.746
Y.Cohen,11,1683315425,90227,01:30.227,43644,46583,00:43.644,00:46.583
OmriF,286,1683394678,90227,01:30.227,43329,46898,00:43.329,00:46.898
Yuval Rosen,50,1683207089,90229,01:30.229,42394,47835,00:42.394,00:47.835
Landzer,74,1683305512,90230,01:30.230,43223,47007,00:43.223,00:47.007
BrAiT_Man,4,1683290752,90231,01:30.231,43574,46657,00:43.574,00:46.657
Idan M,13,1683395624,90245,01:30.245,42959,47286,00:42.959,00:47.286
yarin levi,33,1683365539,90248,01:30.248,43161,47087,00:43.161,00:47.087
OmriF,98,1683237187,90250,01:30.250,43670,46580,00:43.670,00:46.580
yarin levi,85,1683392208,90250,01:30.250,43405,46845,00:43.405,00:46.845
serbansim,14,1683287020,90253,01:30.253,43709,46544,00:43.709,00:46.544
tomerventura,10,1683390691,90255,01:30.255,43337,46918,00:43.337,00:46.918
yarin levi,79,1683389790,90257,01:30.257,42918,47339,00:42.918,00:47.339
SirSiriuSoWhy,9,1683299517,90258,01:30.258,43210,47048,00:43.210,00:47.048
OmriF,143,1683292596,90263,01:30.263,43306,46957,00:43.306,00:46.957
Yuval Rosen,82,1683399233,90265,01:30.265,42128,48137,00:42.128,00:48.137
Landzer,75,1683305602,90277,01:30.277,43562,46715,00:43.562,00:46.715
SirSiriuSoWhy,8,1683299427,90277,01:30.277,43131,47146,00:43.131,00:47.146
OmriF,204,1683381158,90279,01:30.279,43456,46823,00:43.456,00:46.823
Hublot,8,1683402946,90280,01:30.280,43260,47020,00:43.260,00:47.020
U.V,21,1683228924,90281,01:30.281,43531,46750,00:43.531,00:46.750
Crazy,37,1683392689,90285,01:30.285,43849,46436,00:43.849,00:46.436
Ido,39,1683389515,90287,01:30.287,43595,46692,00:43.595,00:46.692
Hublot,30,1683405207,90287,01:30.287,43785,46502,00:43.785,00:46.502
GasCan13,19,1683383873,90289,01:30.289,41693,48596,00:41.693,00:48.596
SirSiriuSoWhy,16,1683300779,90290,01:30.290,43180,47110,00:43.180,00:47.110
Crazy,13,1683390096,90304,01:30.304,43761,46543,00:43.761,00:46.543
leviarnon1,14,1683403989,90309,01:30.309,43221,47088,00:43.221,00:47.088
OmriF,280,1683393449,90312,01:30.312,43327,46985,00:43.327,00:46.985
OmriF,292,1683395253,90314,01:30.314,43830,46484,00:43.830,00:46.484
leviarnon1,3,1683205113,90319,01:30.319,43451,46868,00:43.451,00:46.868
MarkZubarev,13,1683381485,90326,01:30.326,43814,46512,00:43.814,00:46.512
Dori_N,9,1683319026,90327,01:30.327,43995,46332,00:43.995,00:46.332
Michael Simon,12,1683230266,90328,01:30.328,44275,46053,00:44.275,00:46.053
leviarnon1,40,1683406534,90328,01:30.328,42741,47587,00:42.741,00:47.587
Ido,25,1683148213,90330,01:30.330,43822,46508,00:43.822,00:46.508
Ido,82,1683396274,90332,01:30.332,43956,46376,00:43.956,00:46.376
MarkZubarev,5,1683379110,90332,01:30.332,43830,46502,00:43.830,00:46.502
OmriF,93,1683236735,90339,01:30.339,43525,46814,00:43.525,00:46.814
Yuval Rosen,11,1683146114,90342,01:30.342,42547,47795,00:42.547,00:47.795
Yuval Rosen,15,1683146477,90342,01:30.342,42839,47503,00:42.839,00:47.503
Y.Cohen,102,1683390654,90345,01:30.345,42280,48065,00:42.280,00:48.065
OmriF,261,1683388975,90346,01:30.346,43852,46494,00:43.852,00:46.494
IMRACING R16,26,1683405924,90347,01:30.347,43538,46809,00:43.538,00:46.809
Michael Simon,11,1683230176,90348,01:30.348,44164,46184,00:44.164,00:46.184
MarkZubarev,10,1683381214,90350,01:30.350,43573,46777,00:43.573,00:46.777
OmriF,297,1683395737,90357,01:30.357,43962,46395,00:43.962,00:46.395
GasCan13,23,1683384313,90363,01:30.363,41654,48709,00:41.654,00:48.709
OmriF,339,1683401077,90366,01:30.366,43642,46724,00:43.642,00:46.724
MarkZubarev,8,1683379379,90366,01:30.366,43178,47188,00:43.178,00:47.188
Yoni Goldberg,22,1683229378,90368,01:30.368,43645,46723,00:43.645,00:46.723
IMRACING R16,3,1683401438,90374,01:30.374,42827,47547,00:42.827,00:47.547
Ido,41,1683389695,90375,01:30.375,42900,47475,00:42.900,00:47.475
AryeMorZ,38,1683386694,90376,01:30.376,43347,47029,00:43.347,00:47.029
OmriF,211,1683382058,90379,01:30.379,43408,46971,00:43.408,00:46.971
SirSiriuSoWhy,4,1683143624,90382,01:30.382,43955,46427,00:43.955,00:46.427
Ido,12,1683145842,90383,01:30.383,43475,46908,00:43.475,00:46.908
Dori_N,30,1683369199,90384,01:30.384,42828,47556,00:42.828,00:47.556
Y.Cohen,10,1683315335,90386,01:30.386,44203,46183,00:44.203,00:46.183
OmriF,165,1683295074,90387,01:30.387,43550,46837,00:43.550,00:46.837
OmriF,60,1683149228,90391,01:30.391,43631,46760,00:43.631,00:46.760
OmriF,315,1683398099,90392,01:30.392,43475,46917,00:43.475,00:46.917
serbansim,25,1683365419,90394,01:30.394,43751,46643,00:43.751,00:46.643
Landzer,101,1683364190,90403,01:30.403,43544,46859,00:43.544,00:46.859
Idan M,38,1683403653,90408,01:30.408,43931,46477,00:43.931,00:46.477
Michael Simon,15,1683230538,90413,01:30.413,44028,46385,00:44.028,00:46.385
yarin levi,64,1683388137,90415,01:30.415,43647,46768,00:43.647,00:46.768
yarin levi,13,1683314230,90416,01:30.416,44084,46332,00:44.084,00:46.332
BrAiT_Man,12,1683292615,90422,01:30.422,43316,47106,00:43.316,00:47.106
OmriF,179,1683301116,90424,01:30.424,43466,46958,00:43.466,00:46.958
Michael Simon,14,1683230447,90429,01:30.429,44231,46198,00:44.231,00:46.198
GasCan13,40,1683385835,90430,01:30.430,45439,44991,00:45.439,00:44.991
TAL S,36,1683401062,90436,01:30.436,44203,46233,00:44.203,00:46.233
GasCan13,18,1683383783,90439,01:30.439,43472,46967,00:43.472,00:46.967
tomerventura,21,1683393263,90441,01:30.441,43560,46881,00:43.560,00:46.881
OmriF,308,1683396767,90443,01:30.443,43770,46673,00:43.770,00:46.673
serbansim,17,1683287338,90447,01:30.447,44119,46328,00:44.119,00:46.328
Ido,50,1683391279,90455,01:30.455,44241,46214,00:44.241,00:46.214
yarin levi,71,1683389008,90458,01:30.458,44027,46431,00:44.027,00:46.431
OmriF,140,1683242321,90463,01:30.463,43632,46831,00:43.632,00:46.831
chachacha,14,1683234812,90465,01:30.465,42990,47475,00:42.990,00:47.475
yarin levi,88,1683392477,90467,01:30.467,42830,47637,00:42.830,00:47.637
Yuval Rosen,61,1683397198,90467,01:30.467,42043,48424,00:42.043,00:48.424
OmriF,74,1683234622,90468,01:30.468,43451,47017,00:43.451,00:47.017
U.V,32,1683278704,90471,01:30.471,42928,47543,00:42.928,00:47.543
yarin levi,75,1683389422,90473,01:30.473,43331,47142,00:43.331,00:47.142
Michael Simon,13,1683230357,90478,01:30.478,43714,46764,00:43.714,00:46.764
OmriF,148,1683293093,90480,01:30.480,43464,47016,00:43.464,00:47.016
Elad Levy,47,1683300712,90483,01:30.483,42783,47700,00:42.783,00:47.700
Landzer,64,1683230375,90492,01:30.492,43601,46891,00:43.601,00:46.891
OmriF,180,1683301207,90492,01:30.492,43849,46643,00:43.849,00:46.643
yarin levi,44,1683366825,90502,01:30.502,43212,47290,00:43.212,00:47.290
tomerventura,15,1683392693,90508,01:30.508,43636,46872,00:43.636,00:46.872
OmriF,181,1683301298,90508,01:30.508,44126,46382,00:44.126,00:46.382
KirilikBot,23,1683280787,90510,01:30.510,43584,46926,00:43.584,00:46.926
yarin levi,53,1683369183,90510,01:30.510,43142,47368,00:43.142,00:47.368
OmriF,78,1683235017,90513,01:30.513,44253,46260,00:44.253,00:46.260
Landzer,102,1683364281,90518,01:30.518,43844,46674,00:43.844,00:46.674
Ido,45,1683390517,90519,01:30.519,43538,46981,00:43.538,00:46.981
yarin levi,39,1683366108,90521,01:30.521,44055,46466,00:44.055,00:46.466
OmriF,65,1683150063,90536,01:30.536,43525,47011,00:43.525,00:47.011
OmriF,134,1683241707,90536,01:30.536,43961,46575,00:43.961,00:46.575
Idan M,25,1683401253,90539,01:30.539,43695,46844,00:43.695,00:46.844
OmriF,55,1683148720,90542,01:30.542,43932,46610,00:43.932,00:46.610
Y.Cohen,2,1683313934,90545,01:30.545,43791,46754,00:43.791,00:46.754
Michael Simon,9,1683229743,90551,01:30.551,44291,46260,00:44.291,00:46.260
Ido,6,1683144956,90552,01:30.552,44013,46539,00:44.013,00:46.539
Idan M,26,1683401343,90552,01:30.552,43558,46994,00:43.558,00:46.994
OmriF,58,1683149032,90553,01:30.553,43487,47066,00:43.487,00:47.066
OmriF,193,1683379839,90553,01:30.553,43704,46849,00:43.704,00:46.849
serbansim,38,1683381872,90555,01:30.555,44223,46332,00:44.223,00:46.332
Landzer,65,1683230465,90558,01:30.558,43587,46971,00:43.587,00:46.971
Michael Simon,4,1683229082,90558,01:30.558,43694,46864,00:43.694,00:46.864
Yuval Rosen,103,1683401173,90559,01:30.559,41829,48730,00:41.829,00:48.730
OmriF,346,1683402968,90560,01:30.560,43688,46872,00:43.688,00:46.872
IMRACING R16,12,1683402501,90561,01:30.561,42888,47673,00:42.888,00:47.673
Elad Levy,5,1683289692,90570,01:30.570,43837,46733,00:43.837,00:46.733
SHAKED,4,1683228085,90580,01:30.580,43361,47219,00:43.361,00:47.219
Landzer,58,1683229799,90582,01:30.582,43583,46999,00:43.583,00:46.999
Dori_N,51,1683371345,90582,01:30.582,42476,48106,00:42.476,00:48.106
OmriF,269,1683389744,90589,01:30.589,44378,46211,00:44.378,00:46.211
chachacha,70,1683368704,90606,01:30.606,43270,47336,00:43.270,00:47.336
AryeMorZ,63,1683392535,90613,01:30.613,43485,47128,00:43.485,00:47.128
OmriF,111,1683238637,90622,01:30.622,43714,46908,00:43.714,00:46.908
OmriF,131,1683241400,90622,01:30.622,43251,47371,00:43.251,00:47.371
yarin levi,9,1683313834,90625,01:30.625,43708,46917,00:43.708,00:46.917
TAL S,43,1683401978,90628,01:30.628,44017,46611,00:44.017,00:46.611
U.V,42,1683282358,90631,01:30.631,44348,46283,00:44.348,00:46.283
OmriF,104,1683237958,90635,01:30.635,43449,47186,00:43.449,00:47.186
Michael Simon,16,1683230628,90641,01:30.641,44197,46444,00:44.197,00:46.444
serbansim,37,1683381782,90643,01:30.643,43784,46859,00:43.784,00:46.859
Y.Cohen,101,1683390564,90653,01:30.653,45573,45080,00:45.573,00:45.080
Ori Arish,7,1683147052,90659,01:30.659,42982,47677,00:42.982,00:47.677
KirilikBot,10,1683269378,90671,01:30.671,43556,47115,00:43.556,00:47.115
avieinav,3,1683402575,90673,01:30.673,43572,47101,00:43.572,00:47.101
Yuval Rosen,47,1683149891,90674,01:30.674,42394,48280,00:42.394,00:48.280
Hublot,7,1683402855,90676,01:30.676,43926,46750,00:43.926,00:46.750
OmriF,40,1683146800,90683,01:30.683,43924,46759,00:43.924,00:46.759
MarkZubarev,12,1683381394,90683,01:30.683,43807,46876,00:43.807,00:46.876
IMRACING R16,17,1683403036,90695,01:30.695,44404,46291,00:44.404,00:46.291
Landzer,77,1683305818,90696,01:30.696,43886,46810,00:43.886,00:46.810
KirilikBot,11,1683269469,90696,01:30.696,43724,46972,00:43.724,00:46.972
Ido,10,1683145655,90698,01:30.698,43404,47294,00:43.404,00:47.294
avieinav,4,1683402666,90698,01:30.698,44331,46367,00:44.331,00:46.367
Yuval Rosen,52,1683207271,90702,01:30.702,42354,48348,00:42.354,00:48.348
Yuval Rosen,102,1683401083,90706,01:30.706,42416,48290,00:42.416,00:48.290
OmriF,272,1683390049,90708,01:30.708,43745,46963,00:43.745,00:46.963
Boris Fr,157,1683398590,90709,01:30.709,43477,47232,00:43.477,00:47.232
Michael Simon,6,1683229339,90709,01:30.709,43994,46715,00:43.994,00:46.715
Ido,27,1683148394,90722,01:30.722,44129,46593,00:44.129,00:46.593
TAL S,45,1683402157,90727,01:30.727,45043,45684,00:45.043,00:45.684
serbansim,24,1683365328,90728,01:30.728,43838,46890,00:43.838,00:46.890
Yuval Rosen,51,1683207180,90735,01:30.735,42521,48214,00:42.521,00:48.214
Yuval Rosen,76,1683398705,90739,01:30.739,45176,45563,00:45.176,00:45.563
Crazy,26,1683391447,90755,01:30.755,43015,47740,00:43.015,00:47.740
tomerventura,16,1683392784,90757,01:30.757,43579,47178,00:43.579,00:47.178
Yuval Rosen,43,1683149515,90763,01:30.763,43716,47047,00:43.716,00:47.047
itziksamurai1,11,1683374522,90770,01:30.770,43889,46881,00:43.889,00:46.881
Landzer,92,1683363202,90782,01:30.782,43874,46908,00:43.874,00:46.908
AryeMorZ,27,1683289402,90791,01:30.791,44279,46512,00:44.279,00:46.512
Boris Fr,66,1683224419,90791,01:30.791,43326,47465,00:43.326,00:47.465
KirilikBot,7,1683269074,90798,01:30.798,44069,46729,00:44.069,00:46.729
Landzer,94,1683363546,90801,01:30.801,44055,46746,00:44.055,00:46.746
GasCan13,34,1683385284,90804,01:30.804,44364,46440,00:44.364,00:46.440
Landzer,114,1683365372,90807,01:30.807,44133,46674,00:44.133,00:46.674
KirilikBot,28,1683281373,90808,01:30.808,43729,47079,00:43.729,00:47.079
KirilikBot,18,1683270348,90817,01:30.817,43301,47516,00:43.301,00:47.516
Ido,69,1683394447,90821,01:30.821,43329,47492,00:43.329,00:47.492
tomerventura,13,1683392228,90832,01:30.832,43919,46913,00:43.919,00:46.913
A972K,5,1683404911,90836,01:30.836,43856,46980,00:43.856,00:46.980
itziksamurai1,13,1683374713,90836,01:30.836,43267,47569,00:43.267,00:47.569
OmriF,374,1683406429,90844,01:30.844,43513,47331,00:43.513,00:47.331
Michael Simon,3,1683228992,90852,01:30.852,43768,47084,00:43.768,00:47.084
Dori_N,78,1683384991,90852,01:30.852,43826,47026,00:43.826,00:47.026
Yoni Goldberg,13,1683228303,90863,01:30.863,43920,46943,00:43.920,00:46.943
Boris Fr,162,1683399045,90869,01:30.869,43620,47249,00:43.620,00:47.249
OmriF,35,1683146291,90869,01:30.869,43849,47020,00:43.849,00:47.020
OmriF,174,1683298124,90879,01:30.879,45014,45865,00:45.014,00:45.865
Boris Fr,159,1683398772,90885,01:30.885,43770,47115,00:43.770,00:47.115
OmriF,33,1683146109,90889,01:30.889,43751,47138,00:43.751,00:47.138
DoronV,74,1683287058,90893,01:30.893,43761,47132,00:43.761,00:47.132
OmriF,353,1683403762,90897,01:30.897,43696,47201,00:43.696,00:47.201
SirSiriuSoWhy,14,1683300599,90901,01:30.901,43431,47470,00:43.431,00:47.470
Yuval Rosen,73,1683398435,90902,01:30.902,41794,49108,00:41.794,00:49.108
Yoni Goldberg,11,1683228119,90906,01:30.906,43777,47129,00:43.777,00:47.129
Landzer,73,1683305421,90922,01:30.922,43708,47214,00:43.708,00:47.214
AryeMorZ,50,1683387960,90923,01:30.923,43971,46952,00:43.971,00:46.952
itziksamurai1,5,1683208069,90927,01:30.927,44289,46638,00:44.289,00:46.638
Yuval Rosen,5,1683145576,90932,01:30.932,42476,48456,00:42.476,00:48.456
Y.Cohen,25,1683316975,90938,01:30.938,44615,46323,00:44.615,00:46.323
BrAiT_Man,8,1683291666,90943,01:30.943,43607,47336,00:43.607,00:47.336
OmriF,94,1683236826,90944,01:30.944,43195,47749,00:43.195,00:47.749
Dori_N,48,1683370943,90946,01:30.946,42557,48389,00:42.557,00:48.389
Landzer,59,1683229890,90949,01:30.949,44181,46768,00:44.181,00:46.768
Michael Simon,8,1683229653,90950,01:30.950,43984,46966,00:43.984,00:46.966
serbansim,8,1683236822,90957,01:30.957,44085,46872,00:44.085,00:46.872
leviarnon1,9,1683403538,90958,01:30.958,44361,46597,00:44.361,00:46.597
Ido,33,1683149440,90969,01:30.969,43948,47021,00:43.948,00:47.021
serbansim,35,1683381601,90969,01:30.969,44781,46188,00:44.781,00:46.188
Landzer,46,1683188577,90971,01:30.971,43830,47141,00:43.830,00:47.141
IMRACING R16,4,1683401529,90984,01:30.984,43180,47804,00:43.180,00:47.804
SirSiriuSoWhy,5,1683143715,90987,01:30.987,43903,47084,00:43.903,00:47.084
YTS01,39,1683386957,90994,01:30.994,43794,47200,00:43.794,00:47.200
KirilikBot,17,1683270257,91010,01:31.010,43324,47686,00:43.324,00:47.686
A972K,12,1683405769,91011,01:31.011,43319,47692,00:43.319,00:47.692
Boris Fr,161,1683398954,91012,01:31.012,43591,47421,00:43.591,00:47.421
chachacha,29,1683330388,91015,01:31.015,42599,48416,00:42.599,00:48.416
AryeMorZ,11,1683277613,91017,01:31.017,43811,47206,00:43.811,00:47.206
ShimiC,2,1683297638,91017,01:31.017,43703,47314,00:43.703,00:47.314
OmriF,26,1683145231,91020,01:31.020,43977,47043,00:43.977,00:47.043
Landzer,91,1683363111,91023,01:31.023,43651,47372,00:43.651,00:47.372
Dori_N,76,1683384802,91027,01:31.027,42162,48865,00:42.162,00:48.865
OmriF,302,1683396190,91035,01:31.035,43172,47863,00:43.172,00:47.863
Yoni Goldberg,30,1683285898,91036,01:31.036,43979,47057,00:43.979,00:47.057
OmriF,70,1683234092,91040,01:31.040,43264,47776,00:43.264,00:47.776
yarimalk23,28,1683323367,91040,01:31.040,43372,47668,00:43.372,00:47.668
e30misha,39,1683183786,91041,01:31.041,42994,48047,00:42.994,00:48.047
KirilikBot,20,1683270532,91044,01:31.044,43947,47097,00:43.947,00:47.097
TAL S,8,1683317232,91046,01:31.046,43378,47668,00:43.378,00:47.668
Elad Levy,41,1683300017,91073,01:31.073,44544,46529,00:44.544,00:46.529
Landzer,54,1683229434,91080,01:31.080,43956,47124,00:43.956,00:47.124
yarin levi,26,1683364601,91083,01:31.083,44021,47062,00:44.021,00:47.062
TAL S,53,1683402917,91092,01:31.092,43067,48025,00:43.067,00:48.025
serbansim,32,1683378019,91104,01:31.104,43665,47439,00:43.665,00:47.439
Yoni Goldberg,25,1683229655,91111,01:31.111,44460,46651,00:44.460,00:46.651
Crazy,36,1683392598,91111,01:31.111,44590,46521,00:44.590,00:46.521
Landzer,87,1683362678,91112,01:31.112,43647,47465,00:43.647,00:47.465
OmriF,321,1683398870,91120,01:31.120,44536,46584,00:44.536,00:46.584
OmriF,54,1683148630,91127,01:31.127,43706,47421,00:43.706,00:47.421
OmriF,95,1683236917,91128,01:31.128,43239,47889,00:43.239,00:47.889
Landzer,57,1683229708,91129,01:31.129,44230,46899,00:44.230,00:46.899
serbansim,9,1683236913,91129,01:31.129,43938,47191,00:43.938,00:47.191
chachacha,39,1683331391,91133,01:31.133,42083,49050,00:42.083,00:49.050
leviarnon1,29,1683405371,91142,01:31.142,44162,46980,00:44.162,00:46.980
Ido,79,1683395607,91150,01:31.150,44665,46485,00:44.665,00:46.485
OmriF,172,1683297937,91151,01:31.151,43582,47569,00:43.582,00:47.569
serbansim,33,1683378110,91152,01:31.152,44937,46215,00:44.937,00:46.215
Ido,54,1683391814,91155,01:31.155,44507,46648,00:44.507,00:46.648
Dori_N,74,1683384623,91158,01:31.158,42832,48326,00:42.832,00:48.326
Etz,136,1683398507,91161,01:31.161,44054,47107,00:44.054,00:47.107
BrAiT_Man,2,1683290559,91163,01:31.163,44391,46772,00:44.391,00:46.772
DoronV,57,1683283656,91167,01:31.167,43691,47476,00:43.691,00:47.476
OmriF,192,1683379749,91179,01:31.179,44676,46503,00:44.676,00:46.503
OmriF,136,1683241891,91180,01:31.180,43943,47237,00:43.943,00:47.237
OneLeg,3,1683321509,91181,01:31.181,44116,47065,00:44.116,00:47.065
TAL S,16,1683318003,91185,01:31.185,42769,48416,00:42.769,00:48.416
Boris Fr,163,1683399136,91190,01:31.190,43607,47583,00:43.607,00:47.583
Landzer,120,1683366000,91191,01:31.191,43050,48141,00:43.050,00:48.141
Yoni Goldberg,20,1683229181,91208,01:31.208,43733,47475,00:43.733,00:47.475
EDF Tomer Gulak,8,1683240096,91209,01:31.209,44805,46404,00:44.805,00:46.404
Boris Fr,158,1683398681,91211,01:31.211,43458,47753,00:43.458,00:47.753
Elad Levy,2,1683289320,91215,01:31.215,43380,47835,00:43.380,00:47.835
Boris Fr,98,1683292304,91216,01:31.216,44033,47183,00:44.033,00:47.183
DoronV,35,1683242387,91228,01:31.228,43847,47381,00:43.847,00:47.381
KirilikBot,15,1683270064,91232,01:31.232,44356,46876,00:44.356,00:46.876
Boris Fr,160,1683398863,91242,01:31.242,44401,46841,00:44.401,00:46.841
Elad Levy,12,1683290389,91247,01:31.247,43781,47466,00:43.781,00:47.466
Ido,61,1683393129,91251,01:31.251,43209,48042,00:43.209,00:48.042
Boris Fr,60,1683223862,91253,01:31.253,43635,47618,00:43.635,00:47.618
yarimalk23,16,1683300846,91254,01:31.254,42852,48402,00:42.852,00:48.402
Elad Levy,11,1683290297,91255,01:31.255,43928,47327,00:43.928,00:47.327
Landzer,33,1683151398,91264,01:31.264,44216,47048,00:44.216,00:47.048
OmriF,138,1683242083,91270,01:31.270,43876,47394,00:43.876,00:47.394
drdr3vil,64,1683364048,91271,01:31.271,44426,46845,00:44.426,00:46.845
leviarnon1,2,1683205023,91278,01:31.278,44567,46711,00:44.567,00:46.711
Sagy,6,1683300455,91280,01:31.280,44328,46952,00:44.328,00:46.952
yarin levi,23,1683364315,91287,01:31.287,44536,46751,00:44.536,00:46.751
yarin levi,22,1683364223,91293,01:31.293,43219,48074,00:43.219,00:48.074
Idan M,3,1683394290,91301,01:31.301,43439,47862,00:43.439,00:47.862
Hublot,20,1683404281,91303,01:31.303,44323,46980,00:44.323,00:46.980
yarin levi,35,1683365749,91310,01:31.310,43638,47672,00:43.638,00:47.672
YTS01,31,1683356991,91314,01:31.314,43731,47583,00:43.731,00:47.583
DoronV,10,1683204743,91323,01:31.323,44540,46783,00:44.540,00:46.783
YTS01,33,1683357183,91327,01:31.327,44271,47056,00:44.271,00:47.056
Landzer,41,1683188113,91329,01:31.329,43908,47421,00:43.908,00:47.421
OmriF,378,1683406801,91339,01:31.339,44984,46355,00:44.984,00:46.355
YTS01,43,1683387435,91354,01:31.354,43902,47452,00:43.902,00:47.452
Landzer,55,1683229525,91359,01:31.359,43803,47556,00:43.803,00:47.556
Landzer,49,1683188852,91363,01:31.363,43843,47520,00:43.843,00:47.520
AryeMorZ,49,1683387869,91363,01:31.363,43884,47479,00:43.884,00:47.479
Yoni Goldberg,31,1683285989,91392,01:31.392,44128,47264,00:44.128,00:47.264
serbansim,13,1683286930,91393,01:31.393,44480,46913,00:44.480,00:46.913
Crazy,4,1683388737,91396,01:31.396,44051,47345,00:44.051,00:47.345
OmriF,128,1683241117,91400,01:31.400,43300,48100,00:43.300,00:48.100
OmriF,267,1683389561,91410,01:31.410,43606,47804,00:43.606,00:47.804
avieinav,13,1683403554,91419,01:31.419,43421,47998,00:43.421,00:47.998
DoronV,73,1683286968,91421,01:31.421,43821,47600,00:43.821,00:47.600
avieinav,2,1683402484,91421,01:31.421,44639,46782,00:44.639,00:46.782
OmriF,87,1683236008,91422,01:31.422,43398,48024,00:43.398,00:48.024
OmriF,34,1683146201,91441,01:31.441,44403,47038,00:44.403,00:47.038
Yuval Rosen,10,1683146023,91443,01:31.443,42870,48573,00:42.870,00:48.573
avieinav,10,1683403283,91444,01:31.444,44792,46652,00:44.792,00:46.652
Etz,129,1683397443,91462,01:31.462,44199,47263,00:44.199,00:47.263
OmriF,16,1683143467,91467,01:31.467,43964,47503,00:43.964,00:47.503
Landzer,35,1683151586,91477,01:31.477,44844,46633,00:44.844,00:46.633
DoronV,29,1683241653,91488,01:31.488,44098,47390,00:44.098,00:47.390
OmriF,14,1683143281,91489,01:31.489,44194,47295,00:44.194,00:47.295
Crazy,16,1683390480,91490,01:31.490,42719,48771,00:42.719,00:48.771
Boris Fr,152,1683397722,91492,01:31.492,43986,47506,00:43.986,00:47.506
OmriF,10,1683142742,91498,01:31.498,44257,47241,00:44.257,00:47.241
itziksamurai1,10,1683374431,91501,01:31.501,44193,47308,00:44.193,00:47.308
OmriF,288,1683394860,91503,01:31.503,44315,47188,00:44.315,00:47.188
Boris Fr,131,1683379616,91507,01:31.507,43856,47651,00:43.856,00:47.651
GasCan13,29,1683384844,91508,01:31.508,44943,46565,00:44.943,00:46.565
OmriF,191,1683379658,91548,01:31.548,44523,47025,00:44.523,00:47.025
chachacha,18,1683235173,91550,01:31.550,43022,48528,00:43.022,00:48.528
Landzer,27,1683150839,91551,01:31.551,44584,46967,00:44.584,00:46.967
chachacha,34,1683330935,91555,01:31.555,41745,49810,00:41.745,00:49.810
serbansim,12,1683286838,91559,01:31.559,44382,47177,00:44.382,00:47.177
yarin levi,6,1683313546,91564,01:31.564,44372,47192,00:44.372,00:47.192
OmriF,254,1683388280,91572,01:31.572,43516,48056,00:43.516,00:48.056
leviarnon1,17,1683404271,91577,01:31.577,45237,46340,00:45.237,00:46.340
Boris Fr,146,1683382061,91585,01:31.585,43853,47732,00:43.853,00:47.732
OmriF,50,1683148208,91605,01:31.605,43891,47714,00:43.891,00:47.714
AryeMorZ,40,1683386875,91611,01:31.611,43380,48231,00:43.380,00:48.231
Landzer,96,1683363730,91614,01:31.614,43477,48137,00:43.477,00:48.137
Boris Fr,94,1683291929,91621,01:31.621,43961,47660,00:43.961,00:47.660
SirSiriuSoWhy,13,1683300508,91621,01:31.621,44159,47462,00:44.159,00:47.462
OmriF,231,1683385466,91622,01:31.622,44525,47097,00:44.525,00:47.097
Landzer,83,1683306384,91623,01:31.623,44125,47498,00:44.125,00:47.498
KirilikBot,5,1683268879,91630,01:31.630,43412,48218,00:43.412,00:48.218
Landzer,69,1683230841,91642,01:31.642,44280,47362,00:44.280,00:47.362
AryeMorZ,31,1683289903,91645,01:31.645,43266,48379,00:43.266,00:48.379
Crazy,20,1683390862,91645,01:31.645,45129,46516,00:45.129,00:46.516
drdr3vil,67,1683364333,91650,01:31.650,43927,47723,00:43.927,00:47.723
Idan M,2,1683394199,91654,01:31.654,44426,47228,00:44.426,00:47.228
Landzer,48,1683188760,91656,01:31.656,44163,47493,00:44.163,00:47.493
A972K,20,1683406501,91658,01:31.658,43144,48514,00:43.144,00:48.514
Landzer,47,1683188669,91659,01:31.659,43914,47745,00:43.914,00:47.745
Boris Fr,75,1683234551,91666,01:31.666,43970,47696,00:43.970,00:47.696
Yoni Goldberg,16,1683228787,91671,01:31.671,44520,47151,00:44.520,00:47.151
OneLeg,13,1683323024,91680,01:31.680,42638,49042,00:42.638,00:49.042
Crazy,11,1683389787,91686,01:31.686,43603,48083,00:43.603,00:48.083
Ido,4,1683144766,91688,01:31.688,44817,46871,00:44.817,00:46.871
yarin levi,82,1683390061,91696,01:31.696,44009,47687,00:44.009,00:47.687
Boris Fr,89,1683235877,91705,01:31.705,43676,48029,00:43.676,00:48.029
Boris Fr,88,1683235785,91707,01:31.707,43718,47989,00:43.718,00:47.989
Boris Fr,81,1683235104,91710,01:31.710,43478,48232,00:43.478,00:48.232
yarimalk23,4,1683299600,91724,01:31.724,42737,48987,00:42.737,00:48.987
GasCan13,52,1683387297,91726,01:31.726,46506,45220,00:46.506,00:45.220
KirilikBot,27,1683281282,91727,01:31.727,43942,47785,00:43.942,00:47.785
Landzer,56,1683229617,91728,01:31.728,44505,47223,00:44.505,00:47.223
Landzer,100,1683364100,91736,01:31.736,45175,46561,00:45.175,00:46.561
Yuval Rosen,67,1683397905,91751,01:31.751,45919,45832,00:45.919,00:45.832
TAL S,6,1683317039,91760,01:31.760,44362,47398,00:44.362,00:47.398
OmriF,350,1683403491,91763,01:31.763,45391,46372,00:45.391,00:46.372
OmriF,130,1683241310,91765,01:31.765,44655,47110,00:44.655,00:47.110
Landzer,43,1683188297,91769,01:31.769,44259,47510,00:44.259,00:47.510
drdr3vil,57,1683362926,91770,01:31.770,44411,47359,00:44.411,00:47.359
DoronV,42,1683277420,91774,01:31.774,43912,47862,00:43.912,00:47.862
Etz,131,1683397627,91790,01:31.790,44613,47177,00:44.613,00:47.177
Boris Fr,65,1683224328,91791,01:31.791,43965,47826,00:43.965,00:47.826
OmriF,6,1683142343,91805,01:31.805,44753,47052,00:44.753,00:47.052
Landzer,107,1683364731,91821,01:31.821,45155,46666,00:45.155,00:46.666
Yoni Goldberg,23,1683229470,91825,01:31.825,44777,47048,00:44.777,00:47.048
Dori_N,82,1683385365,91832,01:31.832,42099,49733,00:42.099,00:49.733
Boris Fr,149,1683397436,91834,01:31.834,43976,47858,00:43.976,00:47.858
OmriF,100,1683237446,91835,01:31.835,44761,47074,00:44.761,00:47.074
OmriF,216,1683383809,91847,01:31.847,44044,47803,00:44.044,00:47.803
OmriF,122,1683240259,91849,01:31.849,45494,46355,00:45.494,00:46.355
DoronV,81,1683315423,91866,01:31.866,44606,47260,00:44.606,00:47.260
AryeMorZ,30,1683289812,91877,01:31.877,44979,46898,00:44.979,00:46.898
Boris Fr,80,1683235013,91893,01:31.893,44399,47494,00:44.399,00:47.494
Dori_N,37,1683369880,91896,01:31.896,42845,49051,00:42.845,00:49.051
KirilikBot,29,1683281465,91913,01:31.913,44825,47088,00:44.825,00:47.088
DoronV,47,1683278010,91923,01:31.923,44690,47233,00:44.690,00:47.233
serbansim,6,1683236639,91933,01:31.933,44760,47173,00:44.760,00:47.173
Landzer,29,1683151023,91934,01:31.934,44729,47205,00:44.729,00:47.205
Crazy,8,1683389253,91939,01:31.939,43451,48488,00:43.451,00:48.488
Dori_N,54,1683371621,91939,01:31.939,42480,49459,00:42.480,00:49.459
Boris Fr,145,1683381969,91957,01:31.957,43973,47984,00:43.973,00:47.984
Boris Fr,82,1683235196,91966,01:31.966,44388,47578,00:44.388,00:47.578
Yuval Rosen,74,1683398527,91973,01:31.973,42437,49536,00:42.437,00:49.536
Boris Fr,90,1683235969,91976,01:31.976,43727,48249,00:43.727,00:48.249
serbansim,7,1683236731,91976,01:31.976,44636,47340,00:44.636,00:47.340
Boris Fr,128,1683379323,91977,01:31.977,43898,48079,00:43.898,00:48.079
Boris Fr,148,1683397344,91997,01:31.997,44558,47439,00:44.558,00:47.439
drdr3vil,43,1683300429,92000,01,44445,47555,00:44.445,00:47.555
Boris Fr,117,1683298153,92002,01:32.002,44513,47489,00:44.513,00:47.489
Boris Fr,124,1683365919,92017,01:32.017,44713,47304,00:44.713,00:47.304
drdr3vil,66,1683364241,92018,01:32.018,44606,47412,00:44.606,00:47.412
avieinav,8,1683403099,92019,01:32.019,45065,46954,00:45.065,00:46.954
Boris Fr,151,1683397630,92027,01:32.027,44652,47375,00:44.652,00:47.375
Boris Fr,78,1683234828,92028,01:32.028,44431,47597,00:44.431,00:47.597
Landzer,45,1683188486,92031,01:32.031,44078,47953,00:44.078,00:47.953
chachacha,12,1683234635,92034,01:32.034,44477,47557,00:44.477,00:47.557
Landzer,32,1683151307,92043,01:32.043,45062,46981,00:45.062,00:46.981
itziksamurai1,21,1683375607,92044,01:32.044,43921,48123,00:43.921,00:48.123
Landzer,25,1683150654,92047,01:32.047,44770,47277,00:44.770,00:47.277
Boris Fr,51,1683222813,92052,01:32.052,43667,48385,00:43.667,00:48.385
e30misha,2,1683140868,92067,01:32.067,45501,46566,00:45.501,00:46.566
Boris Fr,47,1683222440,92069,01:32.069,43919,48150,00:43.919,00:48.150
Landzer,95,1683363638,92078,01:32.078,45179,46899,00:45.179,00:46.899
Jonathan Gutman,27,1683361252,92083,01:32.083,44666,47417,00:44.666,00:47.417
DoronV,21,1683207646,92084,01:32.084,44691,47393,00:44.691,00:47.393
Yuval Rosen,7,1683145756,92086,01:32.086,42473,49613,00:42.473,00:49.613
Landzer,23,1683150470,92097,01:32.097,44963,47134,00:44.963,00:47.134
OmriF,281,1683393541,92101,01:32.101,44117,47984,00:44.117,00:47.984
Yuval Rosen,29,1683147800,92111,01:32.111,42013,50098,00:42.013,00:50.098
OmriF,271,1683389959,92113,01:32.113,43252,48861,00:43.252,00:48.861
Landzer,28,1683150931,92115,01:32.115,44828,47287,00:44.828,00:47.287
DoronV,67,1683286135,92117,01:32.117,44183,47934,00:44.183,00:47.934
OmriF,153,1683293583,92122,01:32.122,43725,48397,00:43.725,00:48.397
DoronV,49,1683278194,92128,01:32.128,44099,48029,00:44.099,00:48.029
drdr3vil,60,1683363651,92137,01:32.137,44441,47696,00:44.441,00:47.696
Landzer,67,1683230655,92160,01:32.160,44828,47332,00:44.828,00:47.332
yarin levi,4,1683313362,92161,01:32.161,44232,47929,00:44.232,00:47.929
Boris Fr,77,1683234736,92162,01:32.162,44327,47835,00:44.327,00:47.835
Landzer,61,1683230091,92167,01:32.167,44895,47272,00:44.895,00:47.272
OmriF,127,1683241025,92182,01:32.182,45171,47011,00:45.171,00:47.011
DoronV,50,1683278286,92188,01:32.188,44564,47624,00:44.564,00:47.624
yarin levi,7,1683313639,92188,01:32.188,43395,48793,00:43.395,00:48.793
yarin levi,40,1683366200,92198,01:32.198,45093,47105,00:45.093,00:47.105
Boris Fr,156,1683398499,92204,01:32.204,44887,47317,00:44.887,00:47.317
DoronV,80,1683315331,92204,01:32.204,44172,48032,00:44.172,00:48.032
Landzer,42,1683188206,92209,01:32.209,44928,47281,00:44.928,00:47.281
Boris Fr,34,1683151423,92215,01:32.215,44376,47839,00:44.376,00:47.839
TAL S,78,1683406019,92225,01:32.225,45894,46331,00:45.894,00:46.331
DoronV,27,1683241469,92225,01:32.225,44642,47583,00:44.642,00:47.583
Boris Fr,104,1683292995,92232,01:32.232,44226,48006,00:44.226,00:48.006
DoronV,55,1683283471,92232,01:32.232,44468,47764,00:44.468,00:47.764
AryeMorZ,16,1683283422,92239,01:32.239,44620,47619,00:44.620,00:47.619
Yoni Goldberg,29,1683285807,92242,01:32.242,44659,47583,00:44.659,00:47.583
Boris Fr,45,1683222254,92247,01:32.247,44960,47287,00:44.960,00:47.287
OmriF,79,1683235109,92250,01:32.250,43339,48911,00:43.339,00:48.911
Yuval Rosen,40,1683149250,92254,01:32.254,42533,49721,00:42.533,00:49.721
Boris Fr,49,1683222626,92256,01:32.256,44214,48042,00:44.214,00:48.042
DoronV,66,1683286043,92258,01:32.258,44469,47789,00:44.469,00:47.789
Boris Fr,110,1683297073,92259,01:32.259,44410,47849,00:44.410,00:47.849
KirilikBot,26,1683281190,92262,01:32.262,45034,47228,00:45.034,00:47.228
DoronV,31,1683241928,92289,01:32.289,44688,47601,00:44.688,00:47.601
yarimalk23,7,1683300018,92294,01:32.294,46404,45890,00:46.404,00:45.890
serbansim,11,1683286747,92294,01:32.294,44869,47425,00:44.869,00:47.425
Hublot,29,1683405116,92295,01:32.295,43722,48573,00:43.722,00:48.573
TAL S,60,1683403588,92304,01:32.304,42560,49744,00:42.560,00:49.744
Landzer,8,1683148808,92314,01:32.314,44780,47534,00:44.780,00:47.534
drdr3vil,56,1683362834,92314,01:32.314,44223,48091,00:44.223,00:48.091
DoronV,72,1683286876,92322,01:32.322,44041,48281,00:44.041,00:48.281
Hublot,10,1683403145,92323,01:32.323,44119,48204,00:44.119,00:48.204
KirilikBot,4,1683268788,92326,01:32.326,45215,47111,00:45.215,00:47.111
Boris Fr,155,1683398407,92328,01:32.328,44218,48110,00:44.218,00:48.110
Boris Fr,113,1683297403,92335,01:32.335,44531,47804,00:44.531,00:47.804
Boris Fr,141,1683381414,92339,01:32.339,43928,48411,00:43.928,00:48.411
DoronV,69,1683286593,92341,01:32.341,44574,47767,00:44.574,00:47.767
DoronV,19,1683207460,92342,01:32.342,44669,47673,00:44.669,00:47.673
Landzer,19,1683150012,92346,01:32.346,44776,47570,00:44.776,00:47.570
OmriF,294,1683395435,92350,01:32.350,43619,48731,00:43.619,00:48.731
Y.Cohen,99,1683390386,92353,01:32.353,46718,45635,00:46.718,00:45.635
Boris Fr,57,1683223474,92354,01:32.354,44020,48334,00:44.020,00:48.334
drdr3vil,32,1683298697,92362,01:32.362,44432,47930,00:44.432,00:47.930
Landzer,24,1683150562,92367,01:32.367,44693,47674,00:44.693,00:47.674
AryeMorZ,12,1683277706,92367,01:32.367,44235,48132,00:44.235,00:48.132
Boris Fr,83,1683235289,92368,01:32.368,43512,48856,00:43.512,00:48.856
Boris Fr,79,1683234921,92375,01:32.375,44693,47682,00:44.693,00:47.682
DoronV,60,1683284207,92376,01:32.376,43825,48551,00:43.825,00:48.551
A972K,17,1683406231,92377,01:32.377,46229,46148,00:46.229,00:46.148
Boris Fr,58,1683223567,92387,01:32.387,44539,47848,00:44.539,00:47.848
AryeMorZ,70,1683395584,92398,01:32.398,45787,46611,00:45.787,00:46.611
Landzer,14,1683149538,92401,01:32.401,44818,47583,00:44.818,00:47.583
Landzer,17,1683149817,92403,01:32.403,44982,47421,00:44.982,00:47.421
chachacha,44,1683331930,92406,01:32.406,42725,49681,00:42.725,00:49.681
e30misha,20,1683182069,92422,01:32.422,42657,49765,00:42.657,00:49.765
tomerventura,12,1683392137,92424,01:32.424,46002,46422,00:46.002,00:46.422
drdr3vil,52,1683362441,92445,01:32.445,45100,47345,00:45.100,00:47.345
DoronV,48,1683278102,92457,01:32.457,44973,47484,00:44.973,00:47.484
Etz,106,1683368109,92465,01:32.465,44747,47718,00:44.747,00:47.718
OmriF,268,1683389654,92466,01:32.466,43937,48529,00:43.937,00:48.529
OneLeg,15,1683323223,92493,01:32.493,44333,48160,00:44.333,00:48.160
Boris Fr,106,1683293190,92495,01:32.495,44206,48289,00:44.206,00:48.289
Etz,96,1683366456,92496,01:32.496,44966,47530,00:44.966,00:47.530
serbansim,60,1683392700,92500,01:32.500,43225,49275,00:43.225,00:49.275
chachacha,28,1683330297,92510,01:32.510,44495,48015,00:44.495,00:48.015
TAL S,58,1683403382,92512,01:32.512,42747,49765,00:42.747,00:49.765
yarimalk23,9,1683300199,92515,01:32.515,42678,49837,00:42.678,00:49.837
Ido,83,1683396367,92522,01:32.522,46488,46034,00:46.488,00:46.034
Etz,108,1683368295,92523,01:32.523,44908,47615,00:44.908,00:47.615
Landzer,97,1683363823,92528,01:32.528,43874,48654,00:43.874,00:48.654
OmriF,52,1683148397,92541,01:32.541,44507,48034,00:44.507,00:48.034
OmriF,57,1683148941,92544,01:32.544,46288,46256,00:46.288,00:46.256
OmriF,75,1683234715,92546,01:32.546,45431,47115,00:45.431,00:47.115
OmriF,146,1683292868,92551,01:32.551,45481,47070,00:45.481,00:47.070
OneLeg,19,1683323606,92556,01:32.556,43137,49419,00:43.137,00:49.419
YTS01,19,1683300128,92561,01:32.561,44393,48168,00:44.393,00:48.168
Landzer,62,1683230184,92575,01:32.575,44866,47709,00:44.866,00:47.709
Boris Fr,56,1683223382,92575,01:32.575,44087,48488,00:44.087,00:48.488
DoronV,8,1683204559,92582,01:32.582,45125,47457,00:45.125,00:47.457
Yoni Goldberg,12,1683228212,92583,01:32.583,44563,48020,00:44.563,00:48.020
Etz,130,1683397536,92598,01:32.598,44456,48142,00:44.456,00:48.142
Dori_N,44,1683370551,92602,01:32.602,42639,49963,00:42.639,00:49.963
AryeMorZ,8,1683277326,92604,01:32.604,44872,47732,00:44.872,00:47.732
drdr3vil,35,1683299198,92617,01:32.617,44638,47979,00:44.638,00:47.979
drdr3vil,19,1683215358,92621,01:32.621,44341,48280,00:44.341,00:48.280
Boris Fr,111,1683297166,92623,01:32.623,44275,48348,00:44.275,00:48.348
Etz,127,1683396630,92623,01:32.623,45175,47448,00:45.175,00:47.448
YTS01,23,1683355951,92628,01:32.628,44059,48569,00:44.059,00:48.569
drdr3vil,41,1683300244,92632,01:32.632,44433,48199,00:44.433,00:48.199
DoronV,62,1683284394,92633,01:32.633,44303,48330,00:44.303,00:48.330
DoronV,16,1683205876,92638,01:32.638,44821,47817,00:44.821,00:47.817
OmriF,275,1683392471,92644,01:32.644,43598,49046,00:43.598,00:49.046
Landzer,20,1683150105,92655,01:32.655,44423,48232,00:44.423,00:48.232
drdr3vil,42,1683300337,92660,01:32.660,44735,47925,00:44.735,00:47.925
Boris Fr,142,1683381506,92671,01:32.671,44341,48330,00:44.341,00:48.330
DoronV,13,1683205597,92682,01:32.682,44945,47737,00:44.945,00:47.737
Landzer,7,1683148716,92689,01:32.689,44858,47831,00:44.858,00:47.831
DoronV,9,1683204652,92703,01:32.703,45061,47642,00:45.061,00:47.642
Boris Fr,85,1683235483,92720,01:32.720,44323,48397,00:44.323,00:48.397
Boris Fr,96,1683292116,92725,01:32.725,44444,48281,00:44.444,00:48.281
DoronV,12,1683205504,92730,01:32.730,45025,47705,00:45.025,00:47.705
serbansim,4,1683236438,92731,01:32.731,44824,47907,00:44.824,00:47.907
avieinav,9,1683403192,92736,01:32.736,45261,47475,00:45.261,00:47.475
Jonathan Gutman,38,1683362368,92743,01:32.743,45403,47340,00:45.403,00:47.340
Boris Fr,32,1683151237,92749,01:32.749,44783,47966,00:44.783,00:47.966
Crazy,9,1683389346,92750,01:32.750,43583,49167,00:43.583,00:49.167
Boris Fr,164,1683399229,92774,01:32.774,44264,48510,00:44.264,00:48.510
drdr3vil,28,1683298171,92787,01:32.787,44839,47948,00:44.839,00:47.948
Boris Fr,116,1683298061,92790,01:32.790,44284,48506,00:44.284,00:48.506
yossi7385,4,1683215203,92791,01:32.791,45194,47597,00:45.194,00:47.597
DoronV,46,1683277918,92791,01:32.791,44911,47880,00:44.911,00:47.880
Yoni Goldberg,6,1683226464,92813,01:32.813,44925,47888,00:44.925,00:47.888
tomerventura,23,1683393450,92818,01:32.818,46878,45940,00:46.878,00:45.940
Etz,114,1683395112,92819,01:32.819,44894,47925,00:44.894,00:47.925
Yoni Goldberg,7,1683226557,92820,01:32.820,44935,47885,00:44.935,00:47.885
YTS01,10,1683298819,92821,01:32.821,44626,48195,00:44.626,00:48.195
DoronV,26,1683241376,92822,01:32.822,44780,48042,00:44.780,00:48.042
OmriF,135,1683241799,92824,01:32.824,45822,47002,00:45.822,00:47.002
Boris Fr,115,1683297968,92832,01:32.832,44448,48384,00:44.448,00:48.384
DoronV,17,1683205969,92850,01:32.850,45460,47390,00:45.460,00:47.390
DoronV,5,1683204194,92855,01:32.855,44750,48105,00:44.750,00:48.105
Jonathan Gutman,15,1683312003,92875,01:32.875,45495,47380,00:45.495,00:47.380
DoronV,70,1683286685,92876,01:32.876,44483,48393,00:44.483,00:48.393
Boris Fr,102,1683292809,92883,01:32.883,44620,48263,00:44.620,00:48.263
Landzer,16,1683149725,92886,01:32.886,45294,47592,00:45.294,00:47.592
drdr3vil,51,1683362349,92887,01:32.887,44183,48704,00:44.183,00:48.704
Etz,112,1683369230,92890,01:32.890,44637,48253,00:44.637,00:48.253
Boris Fr,132,1683379709,92894,01:32.894,44875,48019,00:44.875,00:48.019
Yoni Goldberg,5,1683226372,92896,01:32.896,44512,48384,00:44.512,00:48.384
YTS01,25,1683356181,92900,01:32.900,44570,48330,00:44.570,00:48.330
OmriF,242,1683387069,92904,01:32.904,43566,49338,00:43.566,00:49.338
OmriF,323,1683399058,92905,01:32.905,43230,49675,00:43.230,00:49.675
drdr3vil,59,1683363559,92916,01:32.916,44577,48339,00:44.577,00:48.339
leviarnon1,10,1683403631,92921,01:32.921,44069,48852,00:44.069,00:48.852
DoronV,41,1683277328,92923,01:32.923,44247,48676,00:44.247,00:48.676
Sagy,7,1683300548,92936,01:32.936,44728,48208,00:44.728,00:48.208
Etz,87,1683364223,92941,01:32.941,44409,48532,00:44.409,00:48.532
tomerventura,17,1683392877,92953,01:32.953,44524,48429,00:44.524,00:48.429
Idan M,24,1683401162,92979,01:32.979,44747,48232,00:44.747,00:48.232
yossi7385,21,1683277531,92988,01:32.988,45395,47593,00:45.395,00:47.593
yarin levi,5,1683313455,92993,01:32.993,44645,48348,00:44.645,00:48.348
DoronV,15,1683205784,92998,01:32.998,45104,47894,00:45.104,00:47.894
DoronV,64,1683285858,93000,01,44858,48142,00:44.858,00:48.142
yarin levi,73,1683389203,93003,01:33.003,43079,49924,00:43.079,00:49.924
OmriF,219,1683384101,93022,01:33.022,43657,49365,00:43.657,00:49.365
Boris Fr,119,1683365252,93024,01:33.024,44927,48097,00:44.927,00:48.097
tomerventura,5,1683379007,93034,01:33.034,43781,49253,00:43.781,00:49.253
Boris Fr,123,1683365827,93040,01:33.040,44921,48119,00:44.921,00:48.119
Landzer,82,1683306292,93041,01:33.041,46314,46727,00:46.314,00:46.727
TAL S,73,1683405560,93048,01:33.048,47094,45954,00:47.094,00:45.954
Landzer,38,1683187831,93050,01:33.050,45162,47888,00:45.162,00:47.888
IMRACING R9,41,1683406467,93062,01:33.062,44517,48545,00:44.517,00:48.545
Landzer,39,1683187924,93072,01:33.072,46289,46783,00:46.289,00:46.783
OmriF,306,1683396568,93072,01:33.072,46173,46899,00:46.173,00:46.899
Boris Fr,109,1683296981,93081,01:33.081,45066,48015,00:45.066,00:48.015
Elad Levy,6,1683289785,93087,01:33.087,44113,48974,00:44.113,00:48.974
avieinav,5,1683402759,93089,01:33.089,44287,48802,00:44.287,00:48.802
OmriF,202,1683380974,93090,01:33.090,45088,48002,00:45.088,00:48.002
Dori_N,36,1683369788,93097,01:33.097,43516,49581,00:43.516,00:49.581
IMRACING R9,43,1683406662,93099,01:33.099,45124,47975,00:45.124,00:47.975
TAL S,5,1683316947,93106,01:33.106,44034,49072,00:44.034,00:49.072
yarin levi,20,1683364020,93110,01:33.110,43786,49324,00:43.786,00:49.324
Boris Fr,133,1683379802,93116,01:33.116,46002,47114,00:46.002,00:47.114
Dori_N,38,1683369973,93127,01:33.127,45135,47992,00:45.135,00:47.992
DoronV,4,1683204101,93146,01:33.146,44893,48253,00:44.893,00:48.253
Landzer,52,1683229095,93148,01:33.148,46060,47088,00:46.060,00:47.088
Boris Fr,139,1683381226,93158,01:33.158,44415,48743,00:44.415,00:48.743
Jonathan Gutman,16,1683312096,93164,01:33.164,45518,47646,00:45.518,00:47.646
DoronV,65,1683285951,93177,01:33.177,44487,48690,00:44.487,00:48.690
OmriF,228,1683385180,93182,01:33.182,46756,46426,00:46.756,00:46.426
Boris Fr,103,1683292902,93186,01:33.186,44392,48794,00:44.392,00:48.794
Ori Arish,2,1683146508,93187,01:33.187,45451,47736,00:45.451,00:47.736
Boris Fr,35,1683151517,93196,01:33.196,44213,48983,00:44.213,00:48.983
DoronV,34,1683242295,93204,01:33.204,45486,47718,00:45.486,00:47.718
DoronV,79,1683315239,93207,01:33.207,45412,47795,00:45.412,00:47.795
Boris Fr,62,1683224049,93231,01:33.231,44009,49222,00:44.009,00:49.222
Boris Fr,129,1683379416,93244,01:33.244,44694,48550,00:44.694,00:48.550
DoronV,20,1683207554,93247,01:33.247,44692,48555,00:44.692,00:48.555
Dori_N,8,1683318936,93260,01:33.260,43756,49504,00:43.756,00:49.504
ElioR_Alkobi,11,1683369649,93266,01:33.266,44783,48483,00:44.783,00:48.483
YTS01,15,1683299594,93281,01:33.281,45280,48001,00:45.280,00:48.001
OmriF,29,1683145690,93284,01:33.284,45108,48176,00:45.108,00:48.176
Boris Fr,48,1683222533,93292,01:33.292,44300,48992,00:44.300,00:48.992
drdr3vil,55,1683362742,93301,01:33.301,45466,47835,00:45.466,00:47.835
Hublot,34,1683405751,93307,01:33.307,43294,50013,00:43.294,00:50.013
Etz,17,1683279310,93309,01:33.309,44555,48754,00:44.555,00:48.754
Ori Arish,19,1683148759,93313,01:33.313,46275,47038,00:46.275,00:47.038
Boris Fr,52,1683222907,93320,01:33.320,45103,48217,00:45.103,00:48.217
Y.Cohen,43,1683365996,93322,01:33.322,43413,49909,00:43.413,00:49.909
Boris Fr,125,1683366012,93327,01:33.327,44483,48844,00:44.483,00:48.844
IMRACING R16,13,1683402594,93329,01:33.329,45701,47628,00:45.701,00:47.628
IMRACING R9,38,1683406174,93339,01:33.339,44352,48987,00:44.352,00:48.987
BrAiT_Man,16,1683294141,93346,01:33.346,45866,47480,00:45.866,00:47.480
Etz,119,1683395667,93347,01:33.347,45224,48123,00:45.224,00:48.123
Boris Fr,14,1683146691,93352,01:33.352,45301,48051,00:45.301,00:48.051
itziksamurai1,18,1683375331,93362,01:33.362,43228,50134,00:43.228,00:50.134
drdr3vil,11,1683214020,93366,01:33.366,44631,48735,00:44.631,00:48.735
Boris Fr,7,1683144892,93393,01:33.393,45139,48254,00:45.139,00:48.254
YTS01,42,1683387344,93405,01:33.405,44453,48952,00:44.453,00:48.952
Landzer,26,1683150748,93407,01:33.407,46189,47218,00:46.189,00:47.218
yossi7385,34,1683279229,93411,01:33.411,45188,48223,00:45.188,00:48.223
Boris Fr,70,1683225002,93415,01:33.415,44388,49027,00:44.388,00:49.027
Boris Fr,64,1683224236,93417,01:33.417,45446,47971,00:45.446,00:47.971
OmriF,85,1683235818,93418,01:33.418,44282,49136,00:44.282,00:49.136
OmriF,203,1683381068,93438,01:33.438,42929,50509,00:42.929,00:50.509
Boris Fr,25,1683148417,93443,01:33.443,45464,47979,00:45.464,00:47.979
drdr3vil,47,1683361758,93444,01:33.444,44106,49338,00:44.106,00:49.338
Boris Fr,73,1683225411,93453,01:33.453,44754,48699,00:44.754,00:48.699
drdr3vil,63,1683363957,93455,01:33.455,44982,48473,00:44.982,00:48.473
DoronV,28,1683241562,93458,01:33.458,44931,48527,00:44.931,00:48.527
Boris Fr,76,1683234644,93461,01:33.461,44389,49072,00:44.389,00:49.072
yarin levi,3,1683313270,93481,01:33.481,43990,49491,00:43.990,00:49.491
KirilikBot,24,1683280881,93496,01:33.496,44275,49221,00:44.275,00:49.221
Landzer,5,1683148522,93502,01:33.502,45708,47794,00:45.708,00:47.794
Corrado_Kid_VR,10,1683291989,93512,01:33.512,45057,48455,00:45.057,00:48.455
KirilikBot,19,1683270441,93516,01:33.516,45023,48493,00:45.023,00:48.493
Etz,107,1683368203,93530,01:33.530,45497,48033,00:45.497,00:48.033
DoronV,14,1683205691,93532,01:33.532,45261,48271,00:45.261,00:48.271
Dori_N,18,1683320002,93544,01:33.544,42698,50846,00:42.698,00:50.846
Etz,126,1683396538,93567,01:33.567,44224,49343,00:44.224,00:49.343
Dori_N,52,1683371439,93572,01:33.572,43838,49734,00:43.838,00:49.734
Crazy,2,1683388422,93579,01:33.579,46382,47197,00:46.382,00:47.197
Idan M,5,1683394483,93597,01:33.597,44663,48934,00:44.663,00:48.934
OmriF,210,1683381967,93601,01:33.601,46869,46732,00:46.869,00:46.732
OmriF,299,1683395920,93602,01:33.602,46020,47582,00:46.020,00:47.582
OmriF,81,1683235304,93604,01:33.604,43613,49991,00:43.613,00:49.991
yossi7385,32,1683279040,93605,01:33.605,45172,48433,00:45.172,00:48.433
drdr3vil,54,1683362648,93605,01:33.605,44915,48690,00:44.915,00:48.690
OmriF,324,1683399152,93606,01:33.606,45249,48357,00:45.249,00:48.357
Boris Fr,40,1683221679,93612,01:33.612,44787,48825,00:44.787,00:48.825
Boris Fr,18,1683147331,93631,01:33.631,44770,48861,00:44.770,00:48.861
ElioR_Alkobi,5,1683198632,93633,01:33.633,44403,49230,00:44.403,00:49.230
Y.Cohen,61,1683386596,93637,01:33.637,47949,45688,00:47.949,00:45.688
drdr3vil,18,1683215265,93653,01:33.653,46075,47578,00:46.075,00:47.578
Boris Fr,46,1683222348,93654,01:33.654,45211,48443,00:45.211,00:48.443
Dori_N,26,1683368785,93662,01:33.662,42718,50944,00:42.718,00:50.944
Jonathan Gutman,32,1683361752,93679,01:33.679,46726,46953,00:46.726,00:46.953
oyway1,2,1683220535,93685,01:33.685,45157,48528,00:45.157,00:48.528
Boris Fr,137,1683380182,93686,01:33.686,43822,49864,00:43.822,00:49.864
OmriF,3,1683142041,93686,01:33.686,45100,48586,00:45.100,00:48.586
Boris Fr,135,1683379991,93688,01:33.688,44219,49469,00:44.219,00:49.469
OmriF,23,1683144941,93689,01:33.689,44171,49518,00:44.171,00:49.518
tomerventura,22,1683393357,93694,01:33.694,43424,50270,00:43.424,00:50.270
A972K,8,1683405185,93711,01:33.711,43878,49833,00:43.878,00:49.833
drdr3vil,14,1683214615,93712,01:33.712,45602,48110,00:45.602,00:48.110
DoronV,44,1683277731,93721,01:33.721,45904,47817,00:45.904,00:47.817
Boris Fr,31,1683151144,93723,01:33.723,45392,48331,00:45.392,00:48.331
KirilikBot,22,1683280697,93739,01:33.739,46683,47056,00:46.683,00:47.056
yarimalk23,48,1683325376,93739,01:33.739,48694,45045,00:48.694,00:45.045
OmriF,344,1683402773,93755,01:33.755,47441,46314,00:47.441,00:46.314
Yoni Goldberg,9,1683227934,93759,01:33.759,44421,49338,00:44.421,00:49.338
oyway1,4,1683220727,93761,01:33.761,44838,48923,00:44.838,00:48.923
Boris Fr,87,1683235693,93781,01:33.781,43962,49819,00:43.962,00:49.819
Boris Fr,61,1683223956,93783,01:33.783,44089,49694,00:44.089,00:49.694
E.vaturi,67,1683403849,93783,01:33.783,44787,48996,00:44.787,00:48.996
yossi7385,36,1683279417,93811,01:33.811,45053,48758,00:45.053,00:48.758
DoronV,45,1683277825,93826,01:33.826,45509,48317,00:45.509,00:48.317
Boris Fr,30,1683151050,93829,01:33.829,45162,48667,00:45.162,00:48.667
Boris Fr,36,1683151610,93835,01:33.835,45942,47893,00:45.942,00:47.893
AryeMorZ,51,1683388054,93836,01:33.836,46177,47659,00:46.177,00:47.659
OmriF,12,1683143095,93841,01:33.841,44543,49298,00:44.543,00:49.298
drdr3vil,31,1683298605,93855,01:33.855,44602,49253,00:44.602,00:49.253
DoronV,56,1683283565,93865,01:33.865,46696,47169,00:46.696,00:47.169
DoronV,3,1683204008,93877,01:33.877,45561,48316,00:45.561,00:48.316
Etz,110,1683369042,93895,01:33.895,46002,47893,00:46.002,00:47.893
E.vaturi,52,1683276598,93897,01:33.897,44918,48979,00:44.918,00:48.979
OmriF,41,1683146894,93904,01:33.904,43985,49919,00:43.985,00:49.919
Yuval Rosen,90,1683399964,93913,01:33.913,41866,52047,00:41.866,00:52.047
AryeMorZ,6,1683276947,93921,01:33.921,46202,47719,00:46.202,00:47.719
Jonathan Gutman,45,1683363068,93942,01:33.942,43856,50086,00:43.856,00:50.086
Landzer,15,1683149632,93943,01:33.943,46220,47723,00:46.220,00:47.723
YTS01,21,1683300317,93943,01:33.943,45275,48668,00:45.275,00:48.668
Etz,39,1683301065,93944,01:33.944,45003,48941,00:45.003,00:48.941
Etz,125,1683396444,93944,01:33.944,44620,49324,00:44.620,00:49.324
OmriF,365,1683405563,93950,01:33.950,45364,48586,00:45.364,00:48.586
Jonathan Gutman,13,1683311808,93959,01:33.959,45413,48546,00:45.413,00:48.546
DoronV,53,1683283177,93960,01:33.960,45463,48497,00:45.463,00:48.497
serbansim,58,1683392501,93972,01:33.972,43365,50607,00:43.365,00:50.607
Boris Fr,41,1683221773,93978,01:33.978,45486,48492,00:45.486,00:48.492
yossi7385,40,1683279861,93981,01:33.981,45362,48619,00:45.362,00:48.619
OmriF,90,1683236448,93981,01:33.981,47585,46396,00:47.585,00:46.396
Etz,85,1683364016,93981,01:33.981,45210,48771,00:45.210,00:48.771
Jonathan Gutman,8,1683311078,93999,01:33.999,44989,49010,00:44.989,00:49.010
Etz,80,1683362914,94013,01:34.013,44406,49607,00:44.406,00:49.607
OmriF,112,1683238731,94019,01:34.019,46625,47394,00:46.625,00:47.394
Ido,46,1683390611,94032,01:34.032,43321,50711,00:43.321,00:50.711
Yoni Goldberg,24,1683229564,94038,01:34.038,47040,46998,00:47.040,00:46.998
Boris Fr,8,1683144986,94041,01:34.041,45476,48565,00:45.476,00:48.565
drdr3vil,40,1683300152,94050,01:34.050,45175,48875,00:45.175,00:48.875
OmriF,177,1683300930,94054,01:34.054,44505,49549,00:44.505,00:49.549
yossi7385,23,1683277945,94057,01:34.057,45993,48064,00:45.993,00:48.064
Hublot,44,1683406856,94066,01:34.066,43140,50926,00:43.140,00:50.926
Ido,3,1683144674,94069,01:34.069,46481,47588,00:46.481,00:47.588
THE GM,11,1683288054,94069,01:34.069,45609,48460,00:45.609,00:48.460
Etz,122,1683396035,94074,01:34.074,45775,48299,00:45.775,00:48.299
serbansim,54,1683392126,94074,01:34.074,43444,50630,00:43.444,00:50.630
OmriF,123,1683240354,94083,01:34.083,46346,47737,00:46.346,00:47.737
ElioR_Alkobi,12,1683369743,94093,01:34.093,45605,48488,00:45.605,00:48.488
yarin levi,58,1683369673,94105,01:34.105,44466,49639,00:44.466,00:49.639
Dori_N,55,1683371715,94114,01:34.114,44204,49910,00:44.204,00:49.910
IMRACING R9,15,1683402286,94132,01:34.132,45186,48946,00:45.186,00:48.946
Boris Fr,63,1683224143,94135,01:34.135,43928,50207,00:43.928,00:50.207
YTS01,29,1683356799,94135,01:34.135,43874,50261,00:43.874,00:50.261
drdr3vil,30,1683298511,94139,01:34.139,46133,48006,00:46.133,00:48.006
yossi7385,8,1683251498,94145,01:34.145,45995,48150,00:45.995,00:48.150
Etz,15,1683279120,94151,01:34.151,45876,48275,00:45.876,00:48.275
OmriF,47,1683147638,94162,01:34.162,43865,50297,00:43.865,00:50.297
chachacha,15,1683234906,94167,01:34.167,42228,51939,00:42.228,00:51.939
Boris Fr,95,1683292023,94172,01:34.172,44114,50058,00:44.114,00:50.058
DoronV,24,1683240891,94198,01:34.198,45440,48758,00:45.440,00:48.758
Landzer,79,1683306001,94208,01:34.208,47980,46228,00:47.980,00:46.228
OmriF,187,1683302214,94210,01:34.210,43738,50472,00:43.738,00:50.472
IMRACING R9,39,1683406269,94212,01:34.212,44104,50108,00:44.104,00:50.108
Landzer,12,1683149198,94216,01:34.216,45116,49100,00:45.116,00:49.100
Landzer,68,1683230749,94221,01:34.221,47227,46994,00:47.227,00:46.994
OmriF,259,1683388795,94222,01:34.222,47786,46436,00:47.786,00:46.436
drdr3vil,10,1683213927,94227,01:34.227,45221,49006,00:45.221,00:49.006
Boris Fr,28,1683150862,94229,01:34.229,46345,47884,00:46.345,00:47.884
OmriF,18,1683143665,94239,01:34.239,47178,47061,00:47.178,00:47.061
e30misha,50,1683215841,94246,01:34.246,43927,50319,00:43.927,00:50.319
yossi7385,35,1683279323,94248,01:34.248,45940,48308,00:45.940,00:48.308
Boris Fr,33,1683151331,94249,01:34.249,44627,49622,00:44.627,00:49.622
Yuval Rosen,97,1683400611,94257,01:34.257,42111,52146,00:42.111,00:52.146
Boris Fr,9,1683145080,94265,01:34.265,45769,48496,00:45.769,00:48.496
Corrado_Kid_VR,6,1683291568,94266,01:34.266,45940,48326,00:45.940,00:48.326
yarimalk23,17,1683300940,94270,01:34.270,42398,51872,00:42.398,00:51.872
OmriF,13,1683143190,94272,01:34.272,46720,47552,00:46.720,00:47.552
Idan M,31,1683402321,94273,01:34.273,47675,46598,00:47.675,00:46.598
U.V,17,1683222180,94283,01:34.283,48095,46188,00:48.095,00:46.188
THE GM,8,1683283741,94300,01:34.300,45547,48753,00:45.547,00:48.753
Boris Fr,4,1683144602,94305,01:34.305,45187,49118,00:45.187,00:49.118
OmriF,320,1683398779,94305,01:34.305,43648,50657,00:43.648,00:50.657
ElioR_Alkobi,4,1683198538,94306,01:34.306,45027,49279,00:45.027,00:49.279
OmriF,15,1683143375,94308,01:34.308,46675,47633,00:46.675,00:47.633
TAL S,54,1683403011,94324,01:34.324,47771,46553,00:47.771,00:46.553
Yoni Goldberg,4,1683226279,94337,01:34.337,45418,48919,00:45.418,00:48.919
IMRACING R9,25,1683404587,94350,01:34.350,45228,49122,00:45.228,00:49.122
Etz,45,1683314158,94396,01:34.396,46237,48159,00:46.237,00:48.159
Etz,81,1683363008,94399,01:34.399,45633,48766,00:45.633,00:48.766
Yoni Goldberg,33,1683286188,94410,01:34.410,44010,50400,00:44.010,00:50.400
AryeMorZ,44,1683387265,94410,01:34.410,47097,47313,00:47.097,00:47.313
Dori_N,63,1683382394,94411,01:34.411,43822,50589,00:43.822,00:50.589
Boris Fr,39,1683221585,94415,01:34.415,45586,48829,00:45.586,00:48.829
yossi7385,20,1683277438,94416,01:34.416,45487,48929,00:45.487,00:48.929
Landzer,122,1683366207,94423,01:34.423,46962,47461,00:46.962,00:47.461
DoronV,61,1683284302,94423,01:34.423,44783,49640,00:44.783,00:49.640
Crazy,21,1683390957,94433,01:34.433,47760,46673,00:47.760,00:46.673
yossi7385,42,1683280218,94437,01:34.437,46035,48402,00:46.035,00:48.402
yossi7385,24,1683278039,94443,01:34.443,45608,48835,00:45.608,00:48.835
BrAiT_Man,9,1683291760,94443,01:34.443,47184,47259,00:47.184,00:47.259
Landzer,10,1683149006,94452,01:34.452,44790,49662,00:44.790,00:49.662
Boris Fr,3,1683144508,94454,01:34.454,45566,48888,00:45.566,00:48.888
Boris Fr,29,1683150957,94458,01:34.458,46015,48443,00:46.015,00:48.443
Or BMW,13,1683300124,94501,01:34.501,46045,48456,00:46.045,00:48.456
YTS01,13,1683299396,94517,01:34.517,45305,49212,00:45.305,00:49.212
Yoni Goldberg,19,1683229090,94571,01:34.571,46876,47695,00:46.876,00:47.695
Etz,84,1683363922,94571,01:34.571,45513,49058,00:45.513,00:49.058
leviarnon1,33,1683405891,94574,01:34.574,46636,47938,00:46.636,00:47.938
Dori_N,14,1683319603,94604,01:34.604,43403,51201,00:43.403,00:51.201
OmriF,194,1683379934,94618,01:34.618,45869,48749,00:45.869,00:48.749
drdr3vil,13,1683214521,94629,01:34.629,45849,48780,00:45.849,00:48.780
IMRACING R9,30,1683405184,94631,01:34.631,43889,50742,00:43.889,00:50.742
OmriF,253,1683388189,94663,01:34.663,46513,48150,00:46.513,00:48.150
Dori_N,43,1683370458,94672,01:34.672,46410,48262,00:46.410,00:48.262
ohad,7,1683275289,94673,01:34.673,45331,49342,00:45.331,00:49.342
chachacha,53,1683332903,94676,01:34.676,41954,52722,00:41.954,00:52.722
IMRACING R9,36,1683405985,94682,01:34.682,45570,49112,00:45.570,00:49.112
Boris Fr,20,1683147522,94686,01:34.686,45392,49294,00:45.392,00:49.294
e30misha,9,1683141806,94695,01:34.695,48102,46593,00:48.102,00:46.593
Elad Levy,14,1683290620,94702,01:34.702,48816,45886,00:48.816,00:45.886
serbansim,29,1683377727,94702,01:34.702,43281,51421,00:43.281,00:51.421
leviarnon1,39,1683406443,94707,01:34.707,48770,45937,00:48.770,00:45.937
yossi7385,31,1683278947,94714,01:34.714,45758,48956,00:45.758,00:48.956
itziksamurai1,20,1683375515,94714,01:34.714,42600,52114,00:42.600,00:52.114
IMRACING R9,12,1683401990,94750,01:34.750,45705,49045,00:45.705,00:49.045
OmriF,322,1683398965,94757,01:34.757,43620,51137,00:43.620,00:51.137
Crazy,32,1683392208,94800,01:34.800,48486,46314,00:48.486,00:46.314
yossi7385,30,1683278852,94802,01:34.802,46292,48510,00:46.292,00:48.510
Ido,20,1683147293,94804,01:34.804,47784,47020,00:47.784,00:47.020
Etz,104,1683367751,94813,01:34.813,46393,48420,00:46.393,00:48.420
OmriF,358,1683404612,94827,01:34.827,48125,46702,00:48.125,00:46.702
Yoni Goldberg,10,1683228028,94855,01:34.855,47583,47272,00:47.583,00:47.272
yarimalk23,6,1683299796,94859,01:34.859,42777,52082,00:42.777,00:52.082
yossi7385,33,1683279135,94872,01:34.872,45718,49154,00:45.718,00:49.154
OmriF,73,1683234532,94878,01:34.878,45049,49829,00:45.049,00:49.829
IMRACING R16,5,1683401778,94892,01:34.892,47121,47771,00:47.121,00:47.771
AryeMorZ,54,1683388350,94908,01:34.908,43837,51071,00:43.837,00:51.071
Corrado_Kid_VR,8,1683291788,94911,01:34.911,45554,49357,00:45.554,00:49.357
E.vaturi,51,1683276504,94911,01:34.911,45235,49676,00:45.235,00:49.676
Boris Fr,67,1683224514,94930,01:34.930,47981,46949,00:47.981,00:46.949
yossi7385,39,1683279767,94937,01:34.937,46157,48780,00:46.157,00:48.780
Etz,48,1683314595,94938,01:34.938,44348,50590,00:44.348,00:50.590
THE GM,10,1683287960,94942,01:34.942,46517,48425,00:46.517,00:48.425
Y.Cohen,83,1683388728,94953,01:34.953,49453,45500,00:49.453,00:45.500
Yuval Rosen,85,1683399506,94954,01:34.954,41890,53064,00:41.890,00:53.064
A972K,2,1683404628,94955,01:34.955,47026,47929,00:47.026,00:47.929
OmriF,338,1683400986,94963,01:34.963,44590,50373,00:44.590,00:50.373
E.vaturi,57,1683401211,94979,01:34.979,45623,49356,00:45.623,00:49.356
serbansim,23,1683365237,95010,01:35.010,47750,47260,00:47.750,00:47.260
chachacha,50,1683332634,95025,01:35.025,41893,53132,00:41.893,00:53.132
E.vaturi,63,1683403461,95026,01:35.026,45386,49640,00:45.386,00:49.640
EDF Tomer Gulak,3,1683228076,95029,01:35.029,43144,51885,00:43.144,00:51.885
Ido,21,1683147388,95032,01:35.032,43611,51421,00:43.611,00:51.421
DoronV,6,1683204289,95033,01:35.033,46713,48320,00:46.713,00:48.320
Hublot,3,1683401880,95033,01:35.033,44841,50192,00:44.841,00:50.192
OmriF,164,1683294983,95040,01:35.040,46205,48835,00:46.205,00:48.835
OmriF,368,1683405837,95047,01:35.047,48715,46332,00:48.715,00:46.332
Hublot,24,1683404653,95081,01:35.081,43052,52029,00:43.052,00:52.029
OmriF,162,1683294766,95082,01:35.082,48048,47034,00:48.048,00:47.034
Ido,59,1683392948,95085,01:35.085,48748,46337,00:48.748,00:46.337
Etz,111,1683369137,95095,01:35.095,45707,49388,00:45.707,00:49.388
YTS01,20,1683300223,95101,01:35.101,47405,47696,00:47.405,00:47.696
E.vaturi,26,1683229562,95112,01:35.112,45899,49213,00:45.899,00:49.213
Yoni Goldberg,27,1683229840,95120,01:35.120,43469,51651,00:43.469,00:51.651
OmriF,316,1683398194,95123,01:35.123,43131,51992,00:43.131,00:51.992
ElioR_Alkobi,3,1683198444,95124,01:35.124,45191,49933,00:45.191,00:49.933
Etz,93,1683364849,95133,01:35.133,44800,50333,00:44.800,00:50.333
IMRACING R9,45,1683406879,95145,01:35.145,45694,49451,00:45.694,00:49.451
Landzer,31,1683151215,95148,01:35.148,47483,47665,00:47.483,00:47.665
Etz,117,1683395471,95153,01:35.153,45307,49846,00:45.307,00:49.846
Etz,79,1683362820,95190,01:35.190,46400,48790,00:46.400,00:48.790
IMRACING R9,26,1683404682,95229,01:35.229,46331,48898,00:46.331,00:48.898
Yuval Rosen,55,1683207655,95253,01:35.253,41892,53361,00:41.892,00:53.361
E.vaturi,70,1683404152,95270,01:35.270,46319,48951,00:46.319,00:48.951
Or BMW,11,1683299614,95278,01:35.278,46214,49064,00:46.214,00:49.064
OmriF,160,1683294581,95279,01:35.279,48182,47097,00:48.182,00:47.097
e30misha,36,1683183511,95287,01:35.287,42866,52421,00:42.866,00:52.421
yarimalk23,13,1683300571,95292,01:35.292,48878,46414,00:48.878,00:46.414
OmriF,176,1683300836,95295,01:35.295,47586,47709,00:47.586,00:47.709
OmriF,241,1683386976,95296,01:35.296,45135,50161,00:45.135,00:50.161
A972K,3,1683404723,95304,01:35.304,48157,47147,00:48.157,00:47.147
EDF Tomer Gulak,5,1683228417,95307,01:35.307,48965,46342,00:48.965,00:46.342
E.vaturi,65,1683403655,95333,01:35.333,47148,48185,00:47.148,00:48.185
IMRACING R9,14,1683402192,95338,01:35.338,46508,48830,00:46.508,00:48.830
Crazy,15,1683390389,95362,01:35.362,48967,46395,00:48.967,00:46.395
YTS01,6,1683298381,95384,01:35.384,45156,50228,00:45.156,00:50.228
Landzer,80,1683306097,95394,01:35.394,43202,52192,00:43.202,00:52.192
Boris Fr,5,1683144698,95399,01:35.399,46804,48595,00:46.804,00:48.595
EDF Tomer Gulak,9,1683240192,95400,01:35.400,42776,52624,00:42.776,00:52.624
Yoni Goldberg,2,1683226075,95422,01:35.422,45008,50414,00:45.008,00:50.414
Crazy,35,1683392507,95430,01:35.430,43234,52196,00:43.234,00:52.196
OmriF,363,1683405087,95446,01:35.446,45158,50288,00:45.158,00:50.288
E.vaturi,48,1683276200,95447,01:35.447,45718,49729,00:45.718,00:49.729
E.vaturi,9,1683147891,95458,01:35.458,46008,49450,00:46.008,00:49.450
Yuval Rosen,34,1683148463,95463,01:35.463,43001,52462,00:43.001,00:52.462
drdr3vil,16,1683215046,95467,01:35.467,47096,48371,00:47.096,00:48.371
Etz,70,1683361695,95468,01:35.468,46680,48788,00:46.680,00:48.788
yossi7385,19,1683277343,95479,01:35.479,46452,49027,00:46.452,00:49.027
Etz,92,1683364753,95483,01:35.483,45790,49693,00:45.790,00:49.693
E.vaturi,20,1683228981,95484,01:35.484,46024,49460,00:46.024,00:49.460
Yuval Rosen,96,1683400517,95487,01:35.487,41577,53910,00:41.577,00:53.910
DoronV,37,1683242584,95489,01:35.489,46376,49113,00:46.376,00:49.113
Etz,89,1683364416,95491,01:35.491,46518,48973,00:46.518,00:48.973
AryeMorZ,75,1683399542,95507,01:35.507,45517,49990,00:45.517,00:49.990
Or BMW,5,1683279519,95541,01:35.541,46846,48695,00:46.846,00:48.695
Boris Fr,50,1683222721,95544,01:35.544,45157,50387,00:45.157,00:50.387
ohad,6,1683275195,95570,01:35.570,44621,50949,00:44.621,00:50.949
Landzer,99,1683364008,95586,01:35.586,48777,46809,00:48.777,00:46.809
Etz,41,1683301258,95595,01:35.595,46252,49343,00:46.252,00:49.343
E.vaturi,38,1683233508,95607,01:35.607,45602,50005,00:45.602,00:50.005
Boris Fr,134,1683379898,95618,01:35.618,44543,51075,00:44.543,00:51.075
Ori Arish,11,1683147583,95645,01:35.645,42748,52897,00:42.748,00:52.897
E.vaturi,58,1683401307,95659,01:35.659,47041,48618,00:47.041,00:48.618
leviarnon1,7,1683403346,95660,01:35.660,43726,51934,00:43.726,00:51.934
e30misha,38,1683183695,95671,01:35.671,42130,53541,00:42.130,00:53.541
YTS01,16,1683299690,95709,01:35.709,44822,50887,00:44.822,00:50.887
Boris Fr,140,1683381321,95736,01:35.736,45912,49824,00:45.912,00:49.824
e30misha,42,1683184059,95748,01:35.748,42328,53420,00:42.328,00:53.420
TAL S,27,1683394959,95763,01:35.763,49430,46333,00:49.430,00:46.333
E.vaturi,44,1683275781,95774,01:35.774,46067,49707,00:46.067,00:49.707
Idan M,7,1683394668,95776,01:35.776,43085,52691,00:43.085,00:52.691
Etz,55,1683315669,95824,01:35.824,44654,51170,00:44.654,00:51.170
Etz,9,1683277858,95826,01:35.826,47235,48591,00:47.235,00:48.591
Corrado_Kid_VR,4,1683291374,95835,01:35.835,46195,49640,00:46.195,00:49.640
yarimalk23,37,1683324225,95846,01:35.846,42324,53522,00:42.324,00:53.522
OmriF,20,1683143941,95864,01:35.864,48849,47015,00:48.849,00:47.015
DoronV,2,1683203914,95867,01:35.867,46449,49418,00:46.449,00:49.418
YTS01,4,1683298145,95869,01:35.869,47319,48550,00:47.319,00:48.550
OmriF,220,1683384196,95873,01:35.873,43480,52393,00:43.480,00:52.393
Yuval Rosen,12,1683146210,95876,01:35.876,42304,53572,00:42.304,00:53.572
Ido,65,1683394087,95885,01:35.885,48752,47133,00:48.752,00:47.133
Boris Fr,144,1683381877,95931,01:35.931,44900,51031,00:44.900,00:51.031
KirilikBot,2,1683268599,95936,01:35.936,48475,47461,00:48.475,00:47.461
THE GM,7,1683283646,95948,01:35.948,46453,49495,00:46.453,00:49.495
E.vaturi,23,1683229271,95993,01:35.993,46502,49491,00:46.502,00:49.491
yarimalk23,15,1683300755,95996,01:35.996,42226,53770,00:42.226,00:53.770
OmriF,2,1683141947,96031,01:36.031,46572,49459,00:46.572,00:49.459
E.vaturi,36,1683233281,96041,01:36.041,44705,51336,00:44.705,00:51.336
yarin levi,90,1683392662,96046,01:36.046,49206,46840,00:49.206,00:46.840
OmriF,173,1683298033,96100,01:36.100,46964,49136,00:46.964,00:49.136
Boris Fr,72,1683225317,96106,01:36.106,46926,49180,00:46.926,00:49.180
Etz,102,1683367073,96111,01:36.111,47875,48236,00:47.875,00:48.236
yossi7385,12,1683251912,96122,01:36.122,46622,49500,00:46.622,00:49.500
yossi7385,43,1683280314,96146,01:36.146,46741,49405,00:46.741,00:49.405
e30misha,61,1683216867,96164,01:36.164,43681,52483,00:43.681,00:52.483
OmriF,379,1683406897,96189,01:36.189,44533,51656,00:44.533,00:51.656
Landzer,30,1683151119,96195,01:36.195,45196,50999,00:45.196,00:50.999
OmriF,178,1683301026,96211,01:36.211,44430,51781,00:44.430,00:51.781
Boris Fr,69,1683224908,96225,01:36.225,47706,48519,00:47.706,00:48.519
Landzer,85,1683306570,96232,01:36.232,49634,46598,00:49.634,00:46.598
serbansim,53,1683392032,96232,01:36.232,50107,46125,00:50.107,00:46.125
AryeMorZ,74,1683399446,96234,01:36.234,43286,52948,00:43.286,00:52.948
E.vaturi,60,1683401546,96244,01:36.244,46010,50234,00:46.010,00:50.234
E.vaturi,22,1683229175,96249,01:36.249,46447,49802,00:46.447,00:49.802
IMRACING R9,37,1683406081,96249,01:36.249,45686,50563,00:45.686,00:50.563
THE GM,43,1683391552,96255,01:36.255,45747,50508,00:45.747,00:50.508
yarin levi,27,1683364697,96255,01:36.255,43226,53029,00:43.226,00:53.029
Boris Fr,19,1683147427,96274,01:36.274,46297,49977,00:46.297,00:49.977
Jonathan Gutman,22,1683360690,96276,01:36.276,46362,49914,00:46.362,00:49.914
yossi7385,17,1683252424,96285,01:36.285,46722,49563,00:46.722,00:49.563
Crazy,22,1683391053,96285,01:36.285,42442,53843,00:42.442,00:53.843
Jonathan Gutman,43,1683362873,96285,01:36.285,46946,49339,00:46.946,00:49.339
OmriF,361,1683404886,96291,01:36.291,50566,45725,00:50.566,00:45.725
Etz,91,1683364658,96302,01:36.302,47486,48816,00:47.486,00:48.816
GasCan13,53,1683387393,96323,01:36.323,42355,53968,00:42.355,00:53.968
E.vaturi,15,1683148762,96334,01:36.334,47581,48753,00:47.581,00:48.753
Or BMW,9,1683279936,96351,01:36.351,47220,49131,00:47.220,00:49.131
OmriF,72,1683234437,96390,01:36.390,48933,47457,00:48.933,00:47.457
yossi7385,7,1683251404,96397,01:36.397,45956,50441,00:45.956,00:50.441
Landzer,44,1683188394,96424,01:36.424,44021,52403,00:44.021,00:52.403
Jonathan Gutman,28,1683361348,96463,01:36.463,47157,49306,00:47.157,00:49.306
chachacha,47,1683332223,96464,01:36.464,48216,48248,00:48.216,00:48.248
chachacha,48,1683332451,96468,01:36.468,47823,48645,00:47.823,00:48.645
E.vaturi,25,1683229467,96489,01:36.489,46493,49996,00:46.493,00:49.996
Crazy,5,1683388833,96521,01:36.521,45834,50687,00:45.834,00:50.687
TAL S,17,1683318100,96525,01:36.525,49788,46737,00:49.788,00:46.737
Jonathan Gutman,7,1683310984,96539,01:36.539,47508,49031,00:47.508,00:49.031
yarimalk23,34,1683323943,96544,01:36.544,49735,46809,00:49.735,00:46.809
Boris Fr,97,1683292213,96562,01:36.562,44362,52200,00:44.362,00:52.200
Dori_N,32,1683369402,96570,01:36.570,42687,53883,00:42.687,00:53.883
Idan M,27,1683401780,96572,01:36.572,48963,47609,00:48.963,00:47.609
Y.Cohen,67,1683387134,96573,01:36.573,42505,54068,00:42.505,00:54.068
KirilikBot,3,1683268695,96573,01:36.573,48692,47881,00:48.692,00:47.881
YTS01,3,1683298049,96577,01:36.577,47482,49095,00:47.482,00:49.095
Yuval Rosen,93,1683400246,96583,01:36.583,49999,46584,00:49.999,00:46.584
drdr3vil,45,1683361565,96585,01:36.585,48020,48565,00:48.020,00:48.565
T.K,3,1683359683,96603,01:36.603,47418,49185,00:47.418,00:49.185
yarimalk23,35,1683324040,96607,01:36.607,41820,54787,00:41.820,00:54.787
OmriF,21,1683144038,96608,01:36.608,49840,46768,00:49.840,00:46.768
OmriF,264,1683389261,96622,01:36.622,49817,46805,00:49.817,00:46.805
Etz,133,1683398024,96624,01:36.624,49184,47440,00:49.184,00:47.440
yarimalk23,23,1683322906,96629,01:36.629,50676,45953,00:50.676,00:45.953
TAL S,49,1683402542,96639,01:36.639,42580,54059,00:42.580,00:54.059
Jonathan Gutman,33,1683361848,96647,01:36.647,44961,51686,00:44.961,00:51.686
yarin levi,43,1683366735,96656,01:36.656,43291,53365,00:43.291,00:53.365
Elad Levy,26,1683292505,96657,01:36.657,48821,47836,00:48.821,00:47.836
Crazy,31,1683392113,96671,01:36.671,42825,53846,00:42.825,00:53.846
Etz,16,1683279216,96712,01:36.712,48436,48276,00:48.436,00:48.276
Etz,49,1683314691,96722,01:36.722,45837,50885,00:45.837,00:50.885
Y.Cohen,103,1683390751,96723,01:36.723,51453,45270,00:51.453,00:45.270
E.vaturi,13,1683148553,96759,01:36.759,46624,50135,00:46.624,00:50.135
Sagy,4,1683300123,96760,01:36.760,46711,50049,00:46.711,00:50.049
KirilikBot,25,1683281098,96761,01:36.761,48908,47853,00:48.908,00:47.853
Boris Fr,136,1683380088,96796,01:36.796,46234,50562,00:46.234,00:50.562
E.vaturi,29,1683229861,96797,01:36.797,47361,49436,00:47.361,00:49.436
OmriF,295,1683395532,96801,01:36.801,49780,47021,00:49.780,00:47.021
Ido,11,1683145752,96811,01:36.811,49075,47736,00:49.075,00:47.736
Etz,75,1683362330,96814,01:36.814,46036,50778,00:46.036,00:50.778
OmriF,106,1683238145,96815,01:36.815,43261,53554,00:43.261,00:53.554
OmriF,51,1683148305,96848,01:36.848,45913,50935,00:45.913,00:50.935
AryeMorZ,56,1683388613,96861,01:36.861,42663,54198,00:42.663,00:54.198
TAL S,13,1683317733,96886,01:36.886,43368,53518,00:43.368,00:53.518
Etz,35,1683300624,96890,01:36.890,45613,51277,00:45.613,00:51.277
Jonathan Gutman,30,1683361549,96954,01:36.954,44628,52326,00:44.628,00:52.326
drdr3vil,3,1683212371,96957,01:36.957,46530,50427,00:46.530,00:50.427
E.vaturi,54,1683400054,96958,01:36.958,46162,50796,00:46.162,00:50.796
E.vaturi,35,1683233185,96977,01:36.977,46712,50265,00:46.712,00:50.265
ElioR_Alkobi,8,1683308226,96996,01:36.996,47244,49752,00:47.244,00:49.752
Etz,74,1683362234,97018,01:37.018,46380,50638,00:46.380,00:50.638
AryeMorZ,10,1683277522,97038,01:37.038,43496,53542,00:43.496,00:53.542
TAL S,3,1683316749,97069,01:37.069,48096,48973,00:48.096,00:48.973
Boris Fr,143,1683381781,97071,01:37.071,48705,48366,00:48.705,00:48.366
YTS01,22,1683355859,97113,01:37.113,48328,48785,00:48.328,00:48.785
A972K,4,1683404821,97119,01:37.119,50652,46467,00:50.652,00:46.467
GasCan13,38,1683385658,97132,01:37.132,51776,45356,00:51.776,00:45.356
E.vaturi,12,1683148456,97137,01:37.137,46408,50729,00:46.408,00:50.729
Landzer,34,1683151495,97147,01:37.147,48223,48924,00:48.223,00:48.924
Ido,8,1683145157,97155,01:37.155,44545,52610,00:44.545,00:52.610
yossi7385,29,1683278757,97165,01:37.165,46607,50558,00:46.607,00:50.558
OmriF,200,1683380660,97190,01:37.190,45962,51228,00:45.962,00:51.228
Landzer,71,1683305233,97194,01:37.194,48229,48965,00:48.229,00:48.965
yossi7385,14,1683252123,97222,01:37.222,47474,49748,00:47.474,00:49.748
OmriF,24,1683145038,97292,01:37.292,49417,47875,00:49.417,00:47.875
yossi7385,16,1683252328,97310,01:37.310,46415,50895,00:46.415,00:50.895
Hublot,31,1683405304,97310,01:37.310,42595,54715,00:42.595,00:54.715
leviarnon1,4,1683205210,97331,01:37.331,51130,46201,00:51.130,00:46.201
yarimalk23,42,1683324693,97359,01:37.359,41910,55449,00:41.910,00:55.449
OmriF,337,1683400891,97380,01:37.380,50219,47161,00:50.219,00:47.161
Idan M,8,1683394766,97394,01:37.394,44029,53365,00:44.029,00:53.365
Landzer,51,1683229003,97400,01:37.400,48796,48604,00:48.796,00:48.604
Hublot,18,1683404101,97403,01:37.403,45253,52150,00:45.253,00:52.150
Elad Levy,30,1683292907,97426,01:37.426,46059,51367,00:46.059,00:51.367
Etz,65,1683317742,97437,01:37.437,47333,50104,00:47.333,00:50.104
AryeMorZ,21,1683288814,97444,01:37.444,42607,54837,00:42.607,00:54.837
E.vaturi,68,1683403946,97447,01:37.447,45013,52434,00:45.013,00:52.434
OmriF,103,1683237867,97450,01:37.450,45997,51453,00:45.997,00:51.453
AryeMorZ,34,1683290189,97479,01:37.479,43519,53960,00:43.519,00:53.960
E.vaturi,7,1683147697,97493,01:37.493,48061,49432,00:48.061,00:49.432
Landzer,66,1683230563,97569,01:37.569,50634,46935,00:50.634,00:46.935
Yuval Rosen,16,1683146575,97605,01:37.605,42624,54981,00:42.624,00:54.981
serbansim,48,1683391435,97618,01:37.618,43227,54391,00:43.227,00:54.391
Ori Arish,17,1683148542,97637,01:37.637,43376,54261,00:43.376,00:54.261
Landzer,11,1683149104,97641,01:37.641,45549,52092,00:45.549,00:52.092
Hublot,43,1683406762,97655,01:37.655,43624,54031,00:43.624,00:54.031
IMRACING R9,11,1683401895,97706,01:37.706,49314,48392,00:49.314,00:48.392
Or BMW,14,1683300222,97728,01:37.728,48322,49406,00:48.322,00:49.406
AryeMorZ,59,1683388888,97747,01:37.747,51145,46602,00:51.145,00:46.602
Etz,40,1683301162,97747,01:37.747,47703,50044,00:47.703,00:50.044
BrAiT_Man,15,1683294047,97772,01:37.772,51234,46538,00:51.234,00:46.538
OmriF,108,1683238367,97774,01:37.774,44931,52843,00:44.931,00:52.843
Dori_N,27,1683368883,97779,01:37.779,42838,54941,00:42.838,00:54.941
Landzer,40,1683188022,97798,01:37.798,44154,53644,00:44.154,00:53.644
OmriF,370,1683406024,97808,01:37.808,51616,46192,00:51.616,00:46.192
oyway1,3,1683220633,97818,01:37.818,44515,53303,00:44.515,00:53.303
OmriF,27,1683145329,97848,01:37.848,50494,47354,00:50.494,00:47.354
ITZYuval,2,1683210574,97866,01:37.866,45103,52763,00:45.103,00:52.763
Hublot,22,1683404469,97879,01:37.879,43154,54725,00:43.154,00:54.725
yossi7385,3,1683215110,97897,01:37.897,48024,49873,00:48.024,00:49.873
Boris Fr,23,1683148225,97920,01:37.920,45908,52012,00:45.908,00:52.012
OmriF,44,1683147199,97938,01:37.938,43893,54045,00:43.893,00:54.045
AryeMorZ,60,1683388986,97943,01:37.943,51261,46682,00:51.261,00:46.682
assaf_itz,34,1683375036,97958,01:37.958,51532,46426,00:51.532,00:46.426
leviarnon1,26,1683405102,97960,01:37.960,43262,54698,00:43.262,00:54.698
Landzer,72,1683305331,97965,01:37.965,43632,54333,00:43.632,00:54.333
Hublot,5,1683402634,97981,01:37.981,49138,48843,00:49.138,00:48.843
AryeMorZ,53,1683388255,97991,01:37.991,49355,48636,00:49.355,00:48.636
IMRACING R9,33,1683405674,98067,01:38.067,44998,53069,00:44.998,00:53.069
TAL S,2,1683316652,98076,01:38.076,47037,51039,00:47.037,00:51.039
Ido,78,1683395515,98099,01:38.099,42912,55187,00:42.912,00:55.187
Dori_N,66,1683383838,98122,01:38.122,42214,55908,00:42.214,00:55.908
OmriF,357,1683404517,98150,01:38.150,51144,47006,00:51.144,00:47.006
Elad Levy,35,1683299187,98151,01:38.151,50176,47975,00:50.176,00:47.975
Etz,88,1683364321,98173,01:38.173,49807,48366,00:49.807,00:48.366
Dori_N,7,1683318842,98180,01:38.180,51570,46610,00:51.570,00:46.610
Elad Levy,4,1683289602,98183,01:38.183,47307,50876,00:47.307,00:50.876
Y.Cohen,88,1683389178,98186,01:38.186,42935,55251,00:42.935,00:55.251
AryeMorZ,32,1683290002,98191,01:38.191,46243,51948,00:46.243,00:51.948
yarin levi,31,1683365342,98204,01:38.204,43710,54494,00:43.710,00:54.494
IMRACING R9,29,1683405090,98236,01:38.236,44772,53464,00:44.772,00:53.464
OmriF,126,1683240933,98259,01:38.259,51202,47057,00:51.202,00:47.057
SHAKED,6,1683228345,98265,01:38.265,44579,53686,00:44.579,00:53.686
yarin levi,77,1683389610,98274,01:38.274,43144,55130,00:43.144,00:55.130
yarimalk23,12,1683300476,98289,01:38.289,52793,45496,00:52.793,00:45.496
OmriF,195,1683380032,98290,01:38.290,50594,47696,00:50.594,00:47.696
serbansim,52,1683391936,98295,01:38.295,52359,45936,00:52.359,00:45.936
DoronV,71,1683286784,98301,01:38.301,46325,51976,00:46.325,00:51.976
E.vaturi,21,1683229079,98315,01:38.315,46116,52199,00:46.116,00:52.199
YTS01,17,1683299788,98325,01:38.325,44730,53595,00:44.730,00:53.595
U.V,36,1683280661,98332,01:38.332,42609,55723,00:42.609,00:55.723
e30misha,28,1683182784,98346,01:38.346,42329,56017,00:42.329,00:56.017
assaf_itz,79,1683380334,98348,01:38.348,42706,55642,00:42.706,00:55.642
Yuval Rosen,44,1683149613,98348,01:38.348,43102,55246,00:43.102,00:55.246
OmriF,171,1683297846,98373,01:38.373,45191,53182,00:45.191,00:53.182
yossi7385,6,1683251307,98378,01:38.378,47835,50543,00:47.835,00:50.543
OmriF,251,1683388004,98417,01:38.417,49894,48523,00:49.894,00:48.523
E.vaturi,8,1683147795,98418,01:38.418,46524,51894,00:46.524,00:51.894
Etz,33,1683299614,98420,01:38.420,47444,50976,00:47.444,00:50.976
Etz,14,1683279025,98429,01:38.429,49434,48995,00:49.434,00:48.995
U.V,19,1683222367,98435,01:38.435,42149,56286,00:42.149,00:56.286
yossi7385,2,1683215012,98457,01:38.457,46963,51494,00:46.963,00:51.494
yarimalk23,30,1683323553,98477,01:38.477,47537,50940,00:47.537,00:50.940
Elad Levy,65,1683405565,98484,01:38.484,49838,48646,00:49.838,00:48.646
Landzer,36,1683151685,98497,01:38.497,47472,51025,00:47.472,00:51.025
Yoni Goldberg,14,1683228401,98503,01:38.503,43873,54630,00:43.873,00:54.630
Yuval Rosen,88,1683399781,98512,01:38.512,41763,56749,00:41.763,00:56.749
Ido,2,1683144580,98521,01:38.521,49453,49068,00:49.453,00:49.068
yossi7385,10,1683251702,98537,01:38.537,49370,49167,00:49.370,00:49.167
Boris Fr,37,1683151709,98569,01:38.569,45037,53532,00:45.037,00:53.532
Etz,24,1683297033,98588,01:38.588,49930,48658,00:49.930,00:48.658
OmriF,152,1683293491,98591,01:38.591,42967,55624,00:42.967,00:55.624
chachacha,35,1683331034,98618,01:38.618,41918,56700,00:41.918,00:56.700
Elad Levy,17,1683291209,98642,01:38.642,43666,54976,00:43.666,00:54.976
Elad Levy,57,1683404439,98654,01:38.654,51769,46885,00:51.769,00:46.885
chachacha,30,1683330487,98681,01:38.681,42072,56609,00:42.072,00:56.609
leviarnon1,22,1683404737,98686,01:38.686,52395,46291,00:52.395,00:46.291
TAL S,46,1683402256,98704,01:38.704,53150,45554,00:53.150,00:45.554
Dori_N,35,1683369695,98707,01:38.707,42831,55876,00:42.831,00:55.876
Idan M,11,1683395296,98714,01:38.714,43176,55538,00:43.176,00:55.538
THE GM,42,1683391456,98724,01:38.724,47329,51395,00:47.329,00:51.395
OmriF,86,1683235916,98736,01:38.736,49047,49689,00:49.047,00:49.689
A972K,22,1683406690,98741,01:38.741,42829,55912,00:42.829,00:55.912
THE GM,27,1683364807,98742,01:38.742,47432,51310,00:47.432,00:51.310
Boris Fr,24,1683148323,98743,01:38.743,49896,48847,00:49.896,00:48.847
U.V,14,1683221898,98744,01:38.744,42764,55980,00:42.764,00:55.980
leviarnon1,20,1683404549,98754,01:38.754,52408,46346,00:52.408,00:46.346
AryeMorZ,72,1683395770,98761,01:38.761,42223,56538,00:42.223,00:56.538
THE GM,24,1683364433,98796,01:38.796,48504,50292,00:48.504,00:50.292
Etz,51,1683315214,98807,01:38.807,49330,49477,00:49.330,00:49.477
Yuval Rosen,91,1683400062,98812,01:38.812,41792,57020,00:41.792,00:57.020
drdr3vil,50,1683362256,98813,01:38.813,50740,48073,00:50.740,00:48.073
Y.Cohen,33,1683317829,98814,01:38.814,42928,55886,00:42.928,00:55.886
Jonathan Gutman,34,1683361947,98822,01:38.822,49880,48942,00:49.880,00:48.942
OmriF,327,1683399531,98837,01:38.837,52119,46718,00:52.119,00:46.718
THE GM,36,1683390636,98878,01:38.878,48059,50819,00:48.059,00:50.819
ohad,3,1683274852,98906,01:38.906,46607,52299,00:46.607,00:52.299
E.vaturi,64,1683403559,98920,01:38.920,46090,52830,00:46.090,00:52.830
E.vaturi,24,1683229370,99030,01:39.030,45236,53794,00:45.236,00:53.794
IMRACING R16,22,1683405566,99037,01:39.037,49325,49712,00:49.325,00:49.712
Idan M,23,1683401069,99054,01:39.054,44235,54819,00:44.235,00:54.819
Dori_N,77,1683384901,99064,01:39.064,42094,56970,00:42.094,00:56.970
e30misha,13,1683181103,99069,01:39.069,52926,46143,00:52.926,00:46.143
yarimalk23,49,1683325476,99078,01:39.078,52979,46099,00:52.979,00:46.099
Boris Fr,120,1683365351,99107,01:39.107,50165,48942,00:50.165,00:48.942
TAL S,72,1683405286,99120,01:39.120,50421,48699,00:50.421,00:48.699
Dori_N,22,1683368413,99144,01:39.144,47407,51737,00:47.407,00:51.737
TAL S,22,1683394465,99150,01:39.150,43282,55868,00:43.282,00:55.868
OmriF,354,1683403861,99152,01:39.152,52551,46601,00:52.551,00:46.601
TAL S,70,1683404927,99175,01:39.175,51997,47178,00:51.997,00:47.178
TAL S,11,1683317527,99192,01:39.192,49944,49248,00:49.944,00:49.248
OmriF,38,1683146605,99249,01:39.249,44695,54554,00:44.695,00:54.554
THE GM,39,1683391065,99257,01:39.257,47661,51596,00:47.661,00:51.596
Dori_N,57,1683371923,99259,01:39.259,42330,56929,00:42.330,00:56.929
TAL S,41,1683401783,99283,01:39.283,50364,48919,00:50.364,00:48.919
AryeMorZ,2,1683276498,99297,01:39.297,49977,49320,00:49.977,00:49.320
Dori_N,49,1683371167,99341,01:39.341,47461,51880,00:47.461,00:51.880
Yuval Rosen,46,1683149800,99348,01:39.348,49677,49671,00:49.677,00:49.671
Etz,67,1683361321,99389,01:39.389,48045,51344,00:48.045,00:51.344
yarin levi,51,1683368986,99401,01:39.401,43610,55791,00:43.610,00:55.791
SirSiriuSoWhy,27,1683367548,99419,01:39.419,44137,55282,00:44.137,00:55.282
E.vaturi,45,1683275881,99457,01:39.457,47464,51993,00:47.464,00:51.993
Idan M,21,1683400594,99462,01:39.462,43747,55715,00:43.747,00:55.715
U.V,15,1683221997,99471,01:39.471,42761,56710,00:42.761,00:56.710
chachacha,9,1683234276,99481,01:39.481,41859,57622,00:41.859,00:57.622
OmriF,284,1683393852,99503,01:39.503,46881,52622,00:46.881,00:52.622
Jonathan Gutman,40,1683362574,99513,01:39.513,51421,48092,00:51.421,00:48.092
ormik_pok,3,1683142250,99517,01:39.517,48132,51385,00:48.132,00:51.385
GasCan13,37,1683385561,99519,01:39.519,53735,45784,00:53.735,00:45.784
Ido,38,1683389425,99525,01:39.525,53481,46044,00:53.481,00:46.044
E.vaturi,43,1683275686,99535,01:39.535,45864,53671,00:45.864,00:53.671
Ido,5,1683144865,99551,01:39.551,44363,55188,00:44.363,00:55.188
drdr3vil,46,1683361665,99580,01:39.580,44405,55175,00:44.405,00:55.175
serbansim,3,1683236345,99585,01:39.585,50904,48681,00:50.904,00:48.681
Idan M,4,1683394390,99601,01:39.601,45439,54162,00:45.439,00:54.162
yarin levi,68,1683388562,99603,01:39.603,45836,53767,00:45.836,00:53.767
Corrado_Kid_VR,5,1683291473,99621,01:39.621,46106,53515,00:46.106,00:53.515
OmriF,7,1683142443,99623,01:39.623,51176,48447,00:51.176,00:48.447
itziksamurai1,15,1683375038,99626,01:39.626,53123,46503,00:53.123,00:46.503
Etz,83,1683363828,99678,01:39.678,49939,49739,00:49.939,00:49.739
AryeMorZ,9,1683277425,99693,01:39.693,43551,56142,00:43.551,00:56.142
YTS01,34,1683357554,99703,01:39.703,51931,47772,00:51.931,00:47.772
Elad Levy,28,1683292720,99704,01:39.704,42919,56785,00:42.919,00:56.785
Jonathan Gutman,42,1683362777,99710,01:39.710,45310,54400,00:45.310,00:54.400
YTS01,2,1683297952,99716,01:39.716,48282,51434,00:48.282,00:51.434
Boris Fr,27,1683150768,99726,01:39.726,51535,48191,00:51.535,00:48.191
DoronV,52,1683283083,99747,01:39.747,45679,54068,00:45.679,00:54.068
assaf_itz,36,1683375225,99757,01:39.757,42881,56876,00:42.881,00:56.876
e30misha,18,1683181888,99774,01:39.774,50215,49559,00:50.215,00:49.559
drdr3vil,61,1683363751,99779,01:39.779,52435,47344,00:52.435,00:47.344
Corrado_Kid_VR,3,1683291278,99782,01:39.782,48847,50935,00:48.847,00:50.935
TAL S,57,1683403289,99805,01:39.805,53721,46084,00:53.721,00:46.084
Ido,81,1683396184,99816,01:39.816,52601,47215,00:52.601,00:47.215
E.vaturi,27,1683229662,99836,01:39.836,46426,53410,00:46.426,00:53.410
Yuval Rosen,1,1683145222,99838,01:39.838,52935,46903,00:52.935,00:46.903
THE GM,35,1683390537,99870,01:39.870,49474,50396,00:49.474,00:50.396
itziksamurai1,3,1683207817,99915,01:39.915,52476,47439,00:52.476,00:47.439
A972K,13,1683405869,99936,01:39.936,53212,46724,00:53.212,00:46.724
AryeMorZ,7,1683277233,99950,01:39.950,52161,47789,00:52.161,00:47.789
yarin levi,12,1683314140,99965,01:39.965,43059,56906,00:43.059,00:56.906
Corrado_Kid_VR,2,1683291178,99993,01:39.993,48512,51481,00:48.512,00:51.481
OmriF,290,1683395074,100027,01:40.027,43242,56785,00:43.242,00:56.785
AryeMorZ,42,1683387064,100039,01:40.039,52406,47633,00:52.406,00:47.633
OneLeg,18,1683323514,100050,01:40.050,50523,49527,00:50.523,00:49.527
yarimalk23,31,1683323653,100064,01:40.064,42163,57901,00:42.163,00:57.901
OmriF,62,1683149689,100086,01:40.086,53398,46688,00:53.398,00:46.688
yarin levi,41,1683366300,100096,01:40.096,43720,56376,00:43.720,00:56.376
itziksamurai1,12,1683374622,100110,01:40.110,45138,54972,00:45.138,00:54.972
chachacha,77,1683369333,100120,01:40.120,52533,47587,00:52.533,00:47.587
OmriF,262,1683389075,100171,01:40.171,46805,53366,00:46.805,00:53.366
yarimalk23,2,1683299418,100190,01:40.190,53174,47016,00:53.174,00:47.016
Landzer,63,1683230284,100243,01:40.243,52714,47529,00:52.714,00:47.529
Sagy,3,1683300026,100252,01:40.252,50243,50009,00:50.243,00:50.009
serbansim,19,1683287528,100280,01:40.280,49088,51192,00:49.088,00:51.192
johnny aberzel,9,1683203742,100283,01:40.283,46778,53505,00:46.778,00:53.505
yossi7385,38,1683279673,100285,01:40.285,45984,54301,00:45.984,00:54.301
SirSiriuSoWhy,19,1683366080,100302,01:40.302,53866,46436,00:53.866,00:46.436
Hublot,32,1683405568,100311,01:40.311,52174,48137,00:52.174,00:48.137
Dori_N,67,1683383938,100338,01:40.338,52772,47566,00:52.772,00:47.566
OneLeg,16,1683323324,100340,01:40.340,43343,56997,00:43.343,00:56.997
THE GM,26,1683364708,100343,01:40.343,48373,51970,00:48.373,00:51.970
Yuval Rosen,49,1683206999,100347,01:40.347,53825,46522,00:53.825,00:46.522
E.vaturi,18,1683228444,100350,01:40.350,49045,51305,00:49.045,00:51.305
e30misha,51,1683215941,100392,01:40.392,42513,57879,00:42.513,00:57.879
e30misha,34,1683183328,100402,01:40.402,43877,56525,00:43.877,00:56.525
Ori Arish,15,1683148355,100427,01:40.427,43768,56659,00:43.768,00:56.659
SirSiriuSoWhy,12,1683300416,100432,01:40.432,53429,47003,00:53.429,00:47.003
drdr3vil,65,1683364149,100442,01:40.442,44413,56029,00:44.413,00:56.029
SirSiriuSoWhy,3,1683143534,100443,01:40.443,51401,49042,00:51.401,00:49.042
E.vaturi,66,1683403755,100451,01:40.451,46227,54224,00:46.227,00:54.224
Jonathan Gutman,44,1683362974,100458,01:40.458,44050,56408,00:44.050,00:56.408
OmriF,82,1683235404,100468,01:40.468,43692,56776,00:43.692,00:56.776
TAL S,21,1683394366,100480,01:40.480,53518,46962,00:53.518,00:46.962
Y.Cohen,41,1683365789,100481,01:40.481,55005,45476,00:55.005,00:45.476
leviarnon1,16,1683404179,100484,01:40.484,49679,50805,00:49.679,00:50.805
AryeMorZ,29,1683289720,100498,01:40.498,47637,52861,00:47.637,00:52.861
Jonathan Gutman,6,1683310888,100501,01:40.501,48355,52146,00:48.355,00:52.146
TAL S,74,1683405660,100507,01:40.507,42497,58010,00:42.497,00:58.010
yarin levi,14,1683314331,100533,01:40.533,43364,57169,00:43.364,00:57.169
YTS01,30,1683356900,100554,01:40.554,43934,56620,00:43.934,00:56.620
Boris Fr,6,1683144798,100605,01:40.605,51775,48830,00:51.775,00:48.830
assaf_itz,15,1683232978,100632,01:40.632,42555,58077,00:42.555,00:58.077
OmriF,317,1683398295,100659,01:40.659,43765,56894,00:43.765,00:56.894
IMRACING R16,16,1683402945,100685,01:40.685,43063,57622,00:43.063,00:57.622
Boris Fr,100,1683292610,100686,01:40.686,43707,56979,00:43.707,00:56.979
yarin levi,11,1683314040,100691,01:40.691,43974,56717,00:43.974,00:56.717
AryeMorZ,15,1683283330,100730,01:40.730,44121,56609,00:44.121,00:56.609
leviarnon1,8,1683403447,100803,01:40.803,53296,47507,00:53.296,00:47.507
Y.Cohen,39,1683318388,100805,01:40.805,42841,57964,00:42.841,00:57.964
IMRACING R9,21,1683402943,100808,01:40.808,45756,55052,00:45.756,00:55.052
TAL S,23,1683394565,100813,01:40.813,43708,57105,00:43.708,00:57.105
OmriF,196,1683380133,100823,01:40.823,43863,56960,00:43.863,00:56.960
YTS01,32,1683357092,100836,01:40.836,51880,48956,00:51.880,00:48.956
Hublot,17,1683404003,100840,01:40.840,43807,57033,00:43.807,00:57.033
leviarnon1,35,1683406080,100848,01:40.848,54300,46548,00:54.300,00:46.548
AryeMorZ,14,1683283229,100859,01:40.859,51503,49356,00:51.503,00:49.356
Yoni Goldberg,18,1683228995,100866,01:40.866,43801,57065,00:43.801,00:57.065
Ido,57,1683392763,100887,01:40.887,54482,46405,00:54.482,00:46.405
GasCan13,54,1683387494,100893,01:40.893,54867,46026,00:54.867,00:46.026
OmriF,331,1683399932,100899,01:40.899,43375,57524,00:43.375,00:57.524
OmriF,9,1683142650,100929,01:40.929,51275,49654,00:51.275,00:49.654
yossi7385,28,1683278660,100951,01:40.951,51609,49342,00:51.609,00:49.342
yarimalk23,43,1683324794,100953,01:40.953,42236,58717,00:42.236,00:58.717
TAL S,47,1683402357,100986,01:40.986,49654,51332,00:49.654,00:51.332
Yuval Rosen,23,1683147268,100993,01:40.993,41917,59076,00:41.917,00:59.076
OneLeg,2,1683321417,100994,01:40.994,50513,50481,00:50.513,00:50.481
OmriF,142,1683292506,100997,01:40.997,50147,50850,00:50.147,00:50.850
OmriF,149,1683293194,101024,01:41.024,50598,50426,00:50.598,00:50.426
OmriF,332,1683400033,101033,01:41.033,54022,47011,00:54.022,00:47.011
OmriF,310,1683396978,101044,01:41.044,42890,58154,00:42.890,00:58.154
Boris Fr,53,1683223068,101048,01:41.048,52835,48213,00:52.835,00:48.213
Dori_N,70,1683384217,101063,01:41.063,42370,58693,00:42.370,00:58.693
Y.Cohen,108,1683391204,101070,01:41.070,42646,58424,00:42.646,00:58.424
OmriF,80,1683235210,101097,01:41.097,53140,47957,00:53.140,00:47.957
Etz,98,1683366661,101116,01:41.116,44893,56223,00:44.893,00:56.223
Crazy,33,1683392309,101142,01:41.142,43326,57816,00:43.326,00:57.816
Yuval Rosen,100,1683400889,101240,01:41.240,43046,58194,00:43.046,00:58.194
Hublot,2,1683401785,101249,01:41.249,48447,52802,00:48.447,00:52.802
Boris Fr,59,1683223770,101255,01:41.255,53123,48132,00:53.123,00:48.132
OmriF,43,1683147101,101274,01:41.274,48452,52822,00:48.452,00:52.822
GasCan13,1,1683382013,101283,01:41.283,56152,45131,00:56.152,00:45.131
OmriF,129,1683241218,101311,01:41.311,49687,51624,00:49.687,00:51.624
Dori_N,47,1683370852,101323,01:41.323,45397,55926,00:45.397,00:55.926
Landzer,109,1683364922,101328,01:41.328,44092,57236,00:44.092,00:57.236
IMRACING R9,42,1683406568,101333,01:41.333,53976,47357,00:53.976,00:47.357
Landzer,90,1683363020,101350,01:41.350,43871,57479,00:43.871,00:57.479
AryeMorZ,37,1683386604,101366,01:41.366,53252,48114,00:53.252,00:48.114
OmriF,373,1683406338,101390,01:41.390,43664,57726,00:43.664,00:57.726
serbansim,57,1683392407,101399,01:41.399,43827,57572,00:43.827,00:57.572
TAL S,7,1683317141,101423,01:41.423,43139,58284,00:43.139,00:58.284
OmriF,88,1683236247,101433,01:41.433,54921,46512,00:54.921,00:46.512
Jonathan Gutman,14,1683311910,101460,01:41.460,45961,55499,00:45.961,00:55.499
Ori Arish,4,1683146748,101473,01:41.473,43972,57501,00:43.972,00:57.501
IMRACING R9,34,1683405775,101479,01:41.479,44617,56862,00:44.617,00:56.862
Landzer,6,1683148623,101480,01:41.480,53259,48221,00:53.259,00:48.221
OmriF,137,1683241992,101494,01:41.494,51805,49689,00:51.805,00:49.689
yarimalk23,46,1683325072,101498,01:41.498,54474,47024,00:54.474,00:47.024
yarimalk23,5,1683299701,101523,01:41.523,56122,45401,00:56.122,00:45.401
tomerventura,2,1683378553,101535,01:41.535,54591,46944,00:54.591,00:46.944
OmriF,377,1683406709,101546,01:41.546,55156,46390,00:55.156,00:46.390
Dori_N,39,1683370075,101552,01:41.552,53547,48005,00:53.547,00:48.005
OmriF,30,1683145792,101558,01:41.558,50385,51173,00:50.385,00:51.173
Landzer,4,1683148428,101602,01:41.602,48439,53163,00:48.439,00:53.163
Y.Cohen,7,1683314983,101648,01:41.648,55186,46462,00:55.186,00:46.462
E.vaturi,34,1683233088,101657,01:41.657,45997,55660,00:45.997,00:55.660
Etz,100,1683366869,101672,01:41.672,45004,56668,00:45.004,00:56.668
DoronV,36,1683242488,101688,01:41.688,53366,48322,00:53.366,00:48.322
Hublot,36,1683405941,101723,01:41.723,54730,46993,00:54.730,00:46.993
Hublot,39,1683406222,101743,01:41.743,45727,56016,00:45.727,00:56.016
IMRACING R9,5,1683400981,101743,01:41.743,48648,53095,00:48.648,00:53.095
Yuval Rosen,30,1683148102,101747,01:41.747,47027,54720,00:47.027,00:54.720
OmriF,5,1683142251,101749,01:41.749,53765,47984,00:53.765,00:47.984
OmriF,185,1683301919,101762,01:41.762,51974,49788,00:51.974,00:49.788
Boris Fr,84,1683235390,101786,01:41.786,54239,47547,00:54.239,00:47.547
KirilikBot,1,1683268503,101827,01:41.827,50653,51174,00:50.653,00:51.174
yarin levi,72,1683389110,101833,01:41.833,42807,59026,00:42.807,00:59.026
assaf_itz,65,1683378909,101863,01:41.863,55585,46278,00:55.585,00:46.278
Hublot,13,1683403426,101863,01:41.863,43359,58504,00:43.359,00:58.504
E.vaturi,28,1683229764,102053,01:42.053,47558,54495,00:47.558,00:54.495
Landzer,88,1683362780,102072,01:42.072,51235,50837,00:51.235,00:50.837
TAL S,35,1683400972,102075,01:42.075,54743,47332,00:54.743,00:47.332
Dori_N,10,1683319128,102104,01:42.104,42925,59179,00:42.925,00:59.179
KirilikBot,16,1683270166,102116,01:42.116,43589,58527,00:43.589,00:58.527
Yoni Goldberg,8,1683227840,102151,01:42.151,52997,49154,00:52.997,00:49.154
Etz,69,1683361600,102151,01:42.151,51287,50864,00:51.287,00:50.864
OmriF,25,1683145140,102152,01:42.152,54443,47709,00:54.443,00:47.709
E.vaturi,6,1683147599,102211,01:42.211,48657,53554,00:48.657,00:53.554
E.vaturi,42,1683275586,102222,01:42.222,47560,54662,00:47.560,00:54.662
OmriF,243,1683387172,102226,01:42.226,43060,59166,00:43.060,00:59.166
Jonathan Gutman,2,1683310459,102227,01:42.227,49920,52307,00:49.920,00:52.307
DoronV,40,1683277235,102269,01:42.269,54434,47835,00:54.434,00:47.835
Jonathan Gutman,37,1683362275,102326,01:42.326,45559,56767,00:45.559,00:56.767
Ido,42,1683389797,102375,01:42.375,43118,59257,00:43.118,00:59.257
e30misha,1,1683140776,102394,01:42.394,55706,46688,00:55.706,00:46.688
OneLeg,11,1683322843,102402,01:42.402,43150,59252,00:43.150,00:59.252
THE GM,33,1683390201,102417,01:42.417,51441,50976,00:51.441,00:50.976
BrAiT_Man,3,1683290662,102427,01:42.427,43634,58793,00:43.634,00:58.793
Crazy,34,1683392412,102446,01:42.446,42867,59579,00:42.867,00:59.579
Yuval Rosen,101,1683400992,102486,01:42.486,42330,60156,00:42.330,01:00.156
Boris Fr,150,1683397538,102551,01:42.551,54280,48271,00:54.280,00:48.271
Boris Fr,105,1683293097,102563,01:42.563,46341,56222,00:46.341,00:56.222
Landzer,81,1683306199,102564,01:42.564,45688,56876,00:45.688,00:56.876
serbansim,46,1683391248,102573,01:42.573,43150,59423,00:43.150,00:59.423
Etz,4,1683148893,102609,01:42.609,49653,52956,00:49.653,00:52.956
Dori_N,23,1683368515,102609,01:42.609,43280,59329,00:43.280,00:59.329
Y.Cohen,37,1683318198,102615,01:42.615,42441,60174,00:42.441,01:00.174
Etz,118,1683395573,102666,01:42.666,44152,58514,00:44.152,00:58.514
drdr3vil,49,1683362157,102722,01:42.722,54757,47965,00:54.757,00:47.965
Landzer,18,1683149920,102757,01:42.757,44792,57965,00:44.792,00:57.965
tomerventura,6,1683389537,102804,01:42.804,55657,47147,00:55.657,00:47.147
Etz,26,1683297250,102825,01:42.825,45710,57115,00:45.710,00:57.115
drdr3vil,2,1683212274,102834,01:42.834,51884,50950,00:51.884,00:50.950
Etz,30,1683298917,102836,01:42.836,46154,56682,00:46.154,00:56.682
OmriF,168,1683295430,102920,01:42.920,43309,59611,00:43.309,00:59.611
assaf_itz,82,1683380614,102968,01:42.968,42547,60421,00:42.547,01:00.421
THE GM,5,1683283440,102977,01:42.977,45018,57959,00:45.018,00:57.959
yarin levi,59,1683369776,103002,01:43.002,42832,60170,00:42.832,01:00.170
Hublot,26,1683404845,103008,01:43.008,43189,59819,00:43.189,00:59.819
yossi7385,25,1683278142,103027,01:43.027,53640,49387,00:53.640,00:49.387
Etz,97,1683366559,103063,01:43.063,46007,57056,00:46.007,00:57.056
OmriF,69,1683234001,103078,01:43.078,45996,57082,00:45.996,00:57.082
johnny aberzel,6,1683203422,103102,01:43.102,47298,55804,00:47.298,00:55.804
tomerventura,18,1683392980,103110,01:43.110,43183,59927,00:43.183,00:59.927
Etz,53,1683315441,103126,01:43.126,44432,58694,00:44.432,00:58.694
A972K,9,1683405288,103149,01:43.149,44140,59009,00:44.140,00:59.009
ormik_pok,2,1683142150,103182,01:43.182,49092,54090,00:49.092,00:54.090
Crazy,6,1683388937,103188,01:43.188,47577,55611,00:47.577,00:55.611
E.vaturi,49,1683276303,103192,01:43.192,45740,57452,00:45.740,00:57.452
THE GM,21,1683364083,103233,01:43.233,50029,53204,00:50.029,00:53.204
Jonathan Gutman,41,1683362677,103275,01:43.275,44275,59000,00:44.275,00
Boris Fr,2,1683144414,103284,01:43.284,45576,57708,00:45.576,00:57.708
THE GM,17,1683363612,103292,01:43.292,49103,54189,00:49.103,00:54.189
tomerventura,20,1683393173,103344,01:43.344,44843,58501,00:44.843,00:58.501
OmriF,155,1683293776,103348,01:43.348,43655,59693,00:43.655,00:59.693
E.vaturi,30,1683229964,103404,01:43.404,45794,57610,00:45.794,00:57.610
OmriF,37,1683146505,103459,01:43.459,55467,47992,00:55.467,00:47.992
KirilikBot,6,1683268983,103474,01:43.474,44542,58932,00:44.542,00:58.932
IMRACING R16,21,1683405292,103486,01:43.486,42929,60557,00:42.929,01:00.557
Landzer,21,1683150208,103491,01:43.491,49180,54311,00:49.180,00:54.311
yarimalk23,33,1683323847,103540,01:43.540,44572,58968,00:44.572,00:58.968
Dori_N,13,1683319508,103579,01:43.579,49826,53753,00:49.826,00:53.753
IMRACING R9,23,1683403151,103626,01:43.626,46633,56993,00:46.633,00:56.993
Or BMW,12,1683300030,103654,01:43.654,54397,49257,00:54.397,00:49.257
OmriF,277,1683392822,103690,01:43.690,57119,46571,00:57.119,00:46.571
AryeMorZ,52,1683388157,103746,01:43.746,56523,47223,00:56.523,00:47.223
yarimalk23,25,1683323097,103862,01:43.862,41983,61879,00:41.983,01:01.879
Boris Fr,99,1683292509,103886,01:43.886,53100,50786,00:53.100,00:50.786
Etz,123,1683396139,103886,01:43.886,45395,58491,00:45.395,00:58.491
Dori_N,3,1683318284,103901,01:43.901,43624,60277,00:43.624,01:00.277
Landzer,9,1683148912,103906,01:43.906,45168,58738,00:45.168,00:58.738
SHAKED,2,1683227887,103983,01:43.983,46058,57925,00:46.058,00:57.925
drdr3vil,8,1683213242,103988,01:43.988,53643,50345,00:53.643,00:50.345
IMRACING R9,17,1683402501,103988,01:43.988,46307,57681,00:46.307,00:57.681
Etz,10,1683277962,104004,01:44.004,52316,51688,00:52.316,00:51.688
Y.Cohen,60,1683386324,104007,01:44.007,42532,61475,00:42.532,01:01.475
Ido,77,1683395417,104052,01:44.052,43067,60985,00:43.067,01:00.985
KirilikBot,21,1683280603,104064,01:44.064,53155,50909,00:53.155,00:50.909
YTS01,9,1683298727,104064,01:44.064,45316,58748,00:45.316,00:58.748
Ido,49,1683391189,104077,01:44.077,50171,53906,00:50.171,00:53.906
e30misha,49,1683215746,104078,01:44.078,55524,48554,00:55.524,00:48.554
yarin levi,18,1683363453,104082,01:44.082,56544,47538,00:56.544,00:47.538
Ido,7,1683145060,104112,01:44.112,44095,60017,00:44.095,01:00.017
YTS01,36,1683386606,104112,01:44.112,55926,48186,00:55.926,00:48.186
yarimalk23,51,1683325667,104147,01:44.147,42290,61857,00:42.290,01:01.857
drdr3vil,26,1683297969,104153,01:44.153,44421,59732,00:44.421,00:59.732
Yoni Goldberg,28,1683285715,104158,01:44.158,55180,48978,00:55.180,00:48.978
OmriF,247,1683387605,104169,01:44.169,42811,61358,00:42.811,01:01.358
Jonathan Gutman,29,1683361452,104203,01:44.203,45267,58936,00:45.267,00:58.936
OmriF,17,1683143571,104211,01:44.211,43703,60508,00:43.703,01:00.508
Boris Fr,55,1683223289,104215,01:44.215,45243,58972,00:45.243,00:58.972
IMRACING R9,22,1683403047,104223,01:44.223,44701,59522,00:44.701,00:59.522
KirilikBot,9,1683269288,104275,01:44.275,57336,46939,00:57.336,00:46.939
yarin levi,61,1683387779,104278,01:44.278,43334,60944,00:43.334,01:00.944
E.vaturi,16,1683148866,104293,01:44.293,50019,54274,00:50.019,00:54.274
OmriF,230,1683385374,104342,01:44.342,58019,46323,00:58.019,00:46.323
Crazy,1,1683388328,104401,01:44.401,55346,49055,00:55.346,00:49.055
ElioR_Alkobi,10,1683369556,104424,01:44.424,52818,51606,00:52.818,00:51.606
Ido,19,1683147198,104447,01:44.447,43243,61204,00:43.243,01:01.204
OmriF,76,1683234820,104528,01:44.528,57251,47277,00:57.251,00:47.277
tomerventura,26,1683394096,104537,01:44.537,50465,54072,00:50.465,00:54.072
E.vaturi,11,1683148359,104568,01:44.568,49136,55432,00:49.136,00:55.432
TAL S,42,1683401887,104603,01:44.603,42972,61631,00:42.972,01:01.631
AryeMorZ,19,1683288384,104620,01:44.620,50759,53861,00:50.759,00:53.861
OmriF,158,1683294102,104627,01:44.627,43733,60894,00:43.733,01:00.894
Boris Fr,17,1683147237,104631,01:44.631,46072,58559,00:46.072,00:58.559
DoronV,23,1683240797,104649,01:44.649,45617,59032,00:45.617,00:59.032
Boris Fr,26,1683150668,104689,01:44.689,55427,49262,00:55.427,00:49.262
tomerventura,9,1683390601,104693,01:44.693,56989,47704,00:56.989,00:47.704
OmriF,39,1683146709,104733,01:44.733,52069,52664,00:52.069,00:52.664
OneLeg,10,1683322741,104754,01:44.754,42923,61831,00:42.923,01:01.831
Yoni Goldberg,32,1683286094,104760,01:44.760,43685,61075,00:43.685,01:01.075
A972K,11,1683405678,104762,01:44.762,55731,49031,00:55.731,00:49.031
Etz,20,1683296556,104811,01:44.811,47831,56980,00:47.831,00:56.980
Dori_N,62,1683382299,104815,01:44.815,42081,62734,00:42.081,01:02.734
drdr3vil,7,1683213138,104825,01:44.825,51627,53198,00:51.627,00:53.198
yarin levi,63,1683388047,104830,01:44.830,42914,61916,00:42.914,01:01.916
THE GM,3,1683283213,104858,01:44.858,46062,58796,00:46.062,00:58.796
Jonathan Gutman,23,1683360795,104926,01:44.926,57604,47322,00:57.604,00:47.322
Boris Fr,122,1683365734,104927,01:44.927,55779,49148,00:55.779,00:49.148
OmriF,175,1683300741,104927,01:44.927,54384,50543,00:54.384,00:50.543
YTS01,14,1683299501,104947,01:44.947,55659,49288,00:55.659,00:49.288
ormik_pok,4,1683142354,104950,01:44.950,50721,54229,00:50.721,00:54.229
Or BMW,6,1683279624,104953,01:44.953,53257,51696,00:53.257,00:51.696
yarin levi,10,1683313939,104964,01:44.964,43971,60993,00:43.971,01:00.993
OmriF,345,1683402878,104996,01:44.996,44089,60907,00:44.089,01:00.907
drdr3vil,25,1683297865,105043,01:45.043,56276,48767,00:56.276,00:48.767
TAL S,4,1683316854,105049,01:45.049,56220,48829,00:56.220,00:48.829
OmriF,356,1683404419,105130,01:45.130,54685,50445,00:54.685,00:50.445
IMRACING R9,6,1683401086,105130,01:45.130,54464,50666,00:54.464,00:50.666
yarin levi,8,1683313744,105171,01:45.171,43714,61457,00:43.714,01:01.457
OmriF,304,1683396385,105188,01:45.188,57165,48023,00:57.165,00:48.023
Idan M,9,1683394871,105266,01:45.266,44584,60682,00:44.584,01:00.682
OmriF,59,1683149137,105324,01:45.324,57718,47606,00:57.718,00:47.606
yarin levi,15,1683314436,105403,01:45.403,43244,62159,00:43.244,01:02.159
OmriF,312,1683397599,105404,01:45.404,42836,62568,00:42.836,01:02.568
Etz,28,1683298178,105427,01:45.427,56242,49185,00:56.242,00:49.185
yarin levi,25,1683364509,105455,01:45.455,43527,61928,00:43.527,01:01.928
IMRACING R9,40,1683406374,105470,01:45.470,50062,55408,00:50.062,00:55.408
OmriF,362,1683404992,105502,01:45.502,43069,62433,00:43.069,01:02.433
yarin levi,17,1683314631,105507,01:45.507,43605,61902,00:43.605,01:01.902
E.vaturi,50,1683276409,105535,01:45.535,44970,60565,00:44.970,01:00.565
Jonathan Gutman,5,1683310787,105620,01:45.620,55706,49914,00:55.706,00:49.914
AryeMorZ,18,1683288280,105621,01:45.621,51863,53758,00:51.863,00:53.758
IMRACING R9,9,1683401502,105652,01:45.652,56373,49279,00:56.373,00:49.279
yossi7385,9,1683251604,105667,01:45.667,46677,58990,00:46.677,00:58.990
serbansim,2,1683236246,105690,01:45.690,57202,48488,00:57.202,00:48.488
serbansim,28,1683377633,105756,01:45.756,59680,46076,00:59.680,00:46.076
ElioR_Alkobi,7,1683308129,105806,01:45.806,46978,58828,00:46.978,00:58.828
Etz,63,1683317464,105825,01:45.825,57071,48754,00:57.071,00:48.754
OmriF,42,1683147000,105841,01:45.841,57102,48739,00:57.102,00:48.739
TAL S,10,1683317428,105872,01:45.872,59532,46340,00:59.532,00:46.340
Yuval Rosen,60,1683397107,105924,01:45.924,43022,62902,00:43.022,01:02.902
TAL S,51,1683402737,105932,01:45.932,42870,63062,00:42.870,01:03.062
IMRACING R9,3,1683400749,105988,01:45.988,50157,55831,00:50.157,00:55.831
IMRACING R16,18,1683405010,106034,01:46.034,59266,46768,00:59.266,00:46.768
OmriF,215,1683383717,106079,01:46.079,55823,50256,00:55.823,00:50.256
Etz,44,1683314064,106089,01:46.089,48120,57969,00:48.120,00:57.969
Jonathan Gutman,39,1683362474,106125,01:46.125,47408,58717,00:47.408,00:58.717
Ori Arish,6,1683146961,106136,01:46.136,58418,47718,00:58.418,00:47.718
Dori_N,34,1683369596,106146,01:46.146,42992,63154,00:42.992,01:03.154
TAL S,19,1683318296,106181,01:46.181,43578,62603,00:43.578,01:02.603
Elad Levy,64,1683405150,106189,01:46.189,59870,46319,00:59.870,00:46.319
OmriF,91,1683236554,106209,01:46.209,51412,54797,00:51.412,00:54.797
Boris Fr,38,1683221491,106228,01:46.228,57322,48906,00:57.322,00:48.906
tomerventura,3,1683378659,106236,01:46.236,44172,62064,00:44.172,01:02.064
Ido,84,1683396473,106257,01:46.257,54057,52200,00:54.057,00:52.200
THE GM,22,1683364189,106258,01:46.258,48158,58100,00:48.158,00:58.100
Landzer,93,1683363456,106260,01:46.260,52170,54090,00:52.170,00:54.090
E.vaturi,33,1683232987,106286,01:46.286,45338,60948,00:45.338,01:00.948
Etz,116,1683395375,106321,01:46.321,45571,60750,00:45.571,01:00.750
Dori_N,31,1683369306,106326,01:46.326,42637,63689,00:42.637,01:03.689
IMRACING R9,27,1683404788,106335,01:46.335,44648,61687,00:44.648,01:01.687
KirilikBot,14,1683269973,106368,01:46.368,44412,61956,00:44.412,01:01.956
Boris Fr,92,1683236863,106422,01:46.422,57961,48461,00:57.961,00:48.461
johnny aberzel,7,1683203529,106444,01:46.444,52430,54014,00:52.430,00:54.014
Boris Fr,101,1683292716,106505,01:46.505,43847,62658,00:43.847,01:02.658
Etz,36,1683300731,106545,01:46.545,44642,61903,00:44.642,01:01.903
Boris Fr,68,1683224620,106547,01:46.547,44371,62176,00:44.371,01:02.176
OmriF,8,1683142549,106589,01:46.589,44966,61623,00:44.966,01:01.623
AryeMorZ,43,1683387171,106611,01:46.611,49595,57016,00:49.595,00:57.016
TAL S,63,1683403919,106645,01:46.645,58855,47790,00:58.855,00:47.790
E.vaturi,40,1683233759,106677,01:46.677,45571,61106,00:45.571,01:01.106
yarin levi,52,1683369093,106729,01:46.729,43472,63257,00:43.472,01:03.257
serbansim,45,1683391146,106773,01:46.773,59824,46949,00:59.824,00:46.949
Yoni Goldberg,21,1683229288,106788,01:46.788,43004,63784,00:43.004,01:03.784
Elad Levy,51,1683301085,106789,01:46.789,60542,46247,01:00.542,00:46.247
OneLeg,14,1683323131,106794,01:46.794,45868,60926,00:45.868,01:00.926
yossi7385,15,1683252230,106808,01:46.808,57884,48924,00:57.884,00:48.924
Or BMW,7,1683279730,106809,01:46.809,46203,60606,00:46.203,01:00.606
A972K,10,1683405573,106835,01:46.835,57205,49630,00:57.205,00:49.630
yarin levi,32,1683365449,106837,01:46.837,59137,47700,00:59.137,00:47.700
serbansim,59,1683392608,106856,01:46.856,43316,63540,00:43.316,01:03.540
IMRACING R9,13,1683402097,106894,01:46.894,44465,62429,00:44.465,01:02.429
Etz,99,1683366768,106953,01:46.953,45757,61196,00:45.757,01:01.196
johnny aberzel,10,1683203849,106963,01:46.963,55627,51336,00:55.627,00:51.336
OmriF,77,1683234927,107013,01:47.013,43765,63248,00:43.765,01:03.248
Corrado_Kid_VR,9,1683291896,107108,01:47.108,48636,58472,00:48.636,00:58.472
tomerventura,4,1683378914,107113,01:47.113,59624,47489,00:59.624,00:47.489
Etz,23,1683296935,107138,01:47.138,58233,48905,00:58.233,00:48.905
BrAiT_Man,6,1683291485,107138,01:47.138,47415,59723,00:47.415,00:59.723
E.vaturi,47,1683276105,107174,01:47.174,47977,59197,00:47.977,00:59.197
OmriF,190,1683379566,107187,01:47.187,52080,55107,00:52.080,00:55.107
THE GM,1,1683282992,107191,01:47.191,55374,51817,00:55.374,00:51.817
Jonathan Gutman,3,1683310566,107192,01:47.192,56271,50921,00:56.271,00:50.921
E.vaturi,3,1683143354,107201,01:47.201,45839,61362,00:45.839,01:01.362
Dori_N,81,1683385273,107206,01:47.206,44854,62352,00:44.854,01:02.352
THE GM,37,1683390743,107222,01:47.222,56917,50305,00:56.917,00:50.305
Ido,36,1683389235,107331,01:47.331,59473,47858,00:59.473,00:47.858
Boris Fr,118,1683365159,107331,01:47.331,58987,48344,00:58.987,00:48.344
Hublot,9,1683403053,107389,01:47.389,44362,63027,00:44.362,01:03.027
E.vaturi,2,1683143247,107393,01:47.393,52034,55359,00:52.034,00:55.359
Etz,101,1683366977,107400,01:47.400,45795,61605,00:45.795,01:01.605
OmriF,89,1683236354,107477,01:47.477,57757,49720,00:57.757,00:49.720
SHAKED,3,1683227994,107478,01:47.478,43352,64126,00:43.352,01:04.126
Hublot,42,1683406664,107539,01:47.539,43131,64408,00:43.131,01:04.408
Etz,72,1683361914,107596,01:47.596,47395,60201,00:47.395,01:00.201
OmriF,208,1683381784,107600,01:47.600,59910,47690,00:59.910,00:47.690
yarimalk23,41,1683324596,107602,01:47.602,42442,65160,00:42.442,01:05.160
Ori Arish,5,1683146855,107637,01:47.637,47642,59995,00:47.642,00:59.995
YTS01,37,1683386714,107721,01:47.721,44063,63658,00:44.063,01:03.658
Yoni Goldberg,17,1683228895,107747,01:47.747,43973,63774,00:43.973,01:03.774
Boris Fr,153,1683397921,107804,01:47.804,58080,49724,00:58.080,00:49.724
yarin levi,54,1683369291,107910,01:47.910,43510,64400,00:43.510,01:04.400
Jonathan Gutman,11,1683311594,108020,01:48.020,47631,60389,00:47.631,01:00.389
yarin levi,2,1683313176,108035,01:48.035,53234,54801,00:53.234,00:54.801
THE GM,15,1683363254,108036,01:48.036,53154,54882,00:53.154,00:54.882
Yoni Goldberg,34,1683286297,108143,01:48.143,45585,62558,00:45.585,01:02.558
Boris Fr,130,1683379524,108150,01:48.150,46085,62065,00:46.085,01:02.065
Jonathan Gutman,19,1683360353,108183,01:48.183,50151,58032,00:50.151,00:58.032
Ori Arish,12,1683147691,108227,01:48.227,43779,64448,00:43.779,01:04.448
OmriF,4,1683142149,108300,01:48.300,55892,52408,00:55.892,00:52.408
Boris Fr,126,1683366121,108301,01:48.301,45378,62923,00:45.378,01:02.923
ohad,9,1683275519,108323,01:48.323,44257,64066,00:44.257,01:04.066
drdr3vil,27,1683298078,108394,01:48.394,44751,63643,00:44.751,01:03.643
TAL S,66,1683404275,108467,01:48.467,61245,47222,01:01.245,00:47.222
OmriF,256,1683388521,108517,01:48.517,43281,65236,00:43.281,01:05.236
OmriF,115,1683239055,108579,01:48.579,47342,61237,00:47.342,01:01.237
E.vaturi,31,1683230073,108589,01:48.589,45625,62964,00:45.625,01:02.964
OmriF,151,1683293392,108598,01:48.598,43758,64840,00:43.758,01:04.840
Jonathan Gutman,31,1683361658,108611,01:48.611,57640,50971,00:57.640,00:50.971
OmriF,222,1683384619,108623,01:48.623,44319,64304,00:44.319,01:04.304
OmriF,307,1683396677,108710,01:48.710,60664,48046,01:00.664,00:48.046
serbansim,5,1683236547,108743,01:48.743,45460,63283,00:45.460,01:03.283
AryeMorZ,22,1683288923,108762,01:48.762,56094,52668,00:56.094,00:52.668
OmriF,232,1683385574,108790,01:48.790,61310,47480,01:01.310,00:47.480
Dori_N,56,1683371824,108842,01:48.842,42306,66536,00:42.306,01:06.536
Etz,77,1683362608,108865,01:48.865,60976,47889,01:00.976,00:47.889
Or BMW,8,1683279839,108886,01:48.886,55876,53010,00:55.876,00:53.010
leviarnon1,1,1683204931,108888,01:48.888,61291,47597,01:01.291,00:47.597
Y.Cohen,59,1683386220,109013,01:49.013,63267,45746,01:03.267,00:45.746
Ido,32,1683149349,109024,01:49.024,48702,60322,00:48.702,01:00.322
TAL S,12,1683317636,109030,01:49.030,43983,65047,00:43.983,01:05.047
YTS01,18,1683300035,109030,01:49.030,52883,56147,00:52.883,00:56.147
Yoni Goldberg,3,1683226184,109032,01:49.032,52993,56039,00:52.993,00:56.039
OmriF,218,1683384007,109046,01:49.046,48828,60218,00:48.828,01:00.218
T.K,2,1683359586,109057,01:49.057,47844,61213,00:47.844,01:01.213
yarin levi,55,1683369400,109075,01:49.075,42930,66145,00:42.930,01:06.145
OmriF,118,1683239344,109101,01:49.101,43571,65530,00:43.571,01:05.530
IMRACING R9,31,1683405294,109137,01:49.137,46006,63131,00:46.006,01:03.131
IMRACING R9,32,1683405576,109184,01:49.184,52304,56880,00:52.304,00:56.880
OmriF,64,1683149972,109198,01:49.198,54788,54410,00:54.788,00:54.410
Etz,37,1683300840,109255,01:49.255,60673,48582,01:00.673,00:48.582
OmriF,205,1683381267,109260,01:49.260,57806,51454,00:57.806,00:51.454
OmriF,309,1683396877,109294,01:49.294,58862,50432,00:58.862,00:50.432
THE GM,9,1683287865,109369,01:49.369,60656,48713,01:00.656,00:48.713
Landzer,60,1683229999,109490,01:49.490,56265,53225,00:56.265,00:53.225
itziksamurai1,17,1683375237,109684,01:49.684,57605,52079,00:57.605,00:52.079
serbansim,1,1683181351,109684,01:49.684,60855,48829,01:00.855,00:48.829
KirilikBot,8,1683269184,109849,01:49.849,62298,47551,01:02.298,00:47.551
OmriF,45,1683147309,109876,01:49.876,51768,58108,00:51.768,00:58.108
assaf_itz,23,1683234246,110006,01:50.006,64214,45792,01:04.214,00:45.792
Boris Fr,42,1683221883,110016,01:50.016,44639,65377,00:44.639,01:05.377
chachacha,45,1683332040,110069,01:50.069,43632,66437,00:43.632,01:06.437
serbansim,31,1683377927,110089,01:50.089,50981,59108,00:50.981,00:59.108
OmriF,48,1683147748,110130,01:50.130,45726,64404,00:45.726,01:04.404
IMRACING R9,19,1683402723,110171,01:50.171,45705,64466,00:45.705,01:04.466
Jonathan Gutman,36,1683362173,110410,01:50.410,50501,59909,00:50.501,00:59.909
OmriF,278,1683392933,110417,01:50.417,51531,58886,00:51.531,00:58.886
SirSiriuSoWhy,6,1683299127,110458,01:50.458,61219,49239,01:01.219,00:49.239
DoronV,51,1683282983,110472,01:50.472,60513,49959,01:00.513,00:49.959
IMRACING R9,8,1683401397,110485,01:50.485,50783,59702,00:50.783,00:59.702
IMRACING R9,16,1683402397,110525,01:50.525,47183,63342,00:47.183,01:03.342
OmriF,36,1683146402,110550,01:50.550,58939,51611,00:58.939,00:51.611
TAL S,20,1683394265,110562,01:50.562,54086,56476,00:54.086,00:56.476
THE GM,6,1683283550,110586,01:50.586,60483,50103,01:00.483,00:50.103
E.vaturi,69,1683404057,110620,01:50.620,58712,51908,00:58.712,00:51.908
OmriF,227,1683385087,110797,01:50.797,63236,47561,01:03.236,00:47.561
yossi7385,27,1683278559,110819,01:50.819,45516,65303,00:45.516,01:05.303
OmriF,343,1683402679,110840,01:50.840,44353,66487,00:44.353,01:06.487
Elad Levy,1,1683289228,111003,01:51.003,63446,47557,01:03.446,00:47.557
OmriF,183,1683301728,111197,01:51.197,43742,67455,00:43.742,01:07.455
Or BMW,4,1683279423,111199,01:51.199,45580,65619,00:45.580,01:05.619
Dori_N,6,1683318573,111278,01:51.278,42662,68616,00:42.662,01:08.616
Ori Arish,8,1683147163,111350,01:51.350,45088,66262,00:45.088,01:06.262
OmriF,83,1683235516,111376,01:51.376,43673,67703,00:43.673,01:07.703
ElioR_Alkobi,2,1683198349,111449,01:51.449,46280,65169,00:46.280,01:05.169
Ido,13,1683145954,111494,01:51.494,42879,68615,00:42.879,01:08.615
E.vaturi,10,1683148254,111547,01:51.547,62020,49527,01:02.020,00:49.527
assaf_itz,66,1683379021,111551,01:51.551,65399,46152,01:05.399,00:46.152
Etz,71,1683361807,111553,01:51.553,62508,49045,01:02.508,00:49.045
yarin levi,21,1683364132,111616,01:51.616,43959,67657,00:43.959,01:07.657
EDF Tomer Gulak,6,1683239802,111705,01:51.705,64500,47205,01:04.500,00:47.205
Etz,21,1683296667,111721,01:51.721,49684,62037,00:49.684,01:02.037
Ido,43,1683389909,111789,01:51.789,65461,46328,01:05.461,00:46.328
Boris Fr,114,1683297875,111871,01:51.871,63447,48424,01:03.447,00:48.424
Crazy,19,1683390771,111881,01:51.881,43211,68670,00:43.211,01:08.670
johnny aberzel,1,1683202739,111928,01:51.928,59665,52263,00:59.665,00:52.263
tomerventura,1,1683377448,111947,01:51.947,50891,61056,00:50.891,01:01.056
Landzer,121,1683366112,111996,01:51.996,63045,48951,01:03.045,00:48.951
Dori_N,46,1683370750,112204,01:52.204,42108,70096,00:42.108,01:10.096
Etz,31,1683299029,112219,01:52.219,62255,49964,01:02.255,00:49.964
Ido,73,1683395013,112317,01:52.317,64774,47543,01:04.774,00:47.543
IMRACING R9,18,1683402613,112322,01:52.322,48143,64179,00:48.143,01:04.179
OmriF,167,1683295327,112354,01:52.354,44107,68247,00:44.107,01:08.247
drdr3vil,44,1683361468,112438,01:52.438,64355,48083,01:04.355,00:48.083
Landzer,2,1683148112,112445,01:52.445,60529,51916,01:00.529,00:51.916
Jonathan Gutman,25,1683361028,112541,01:52.541,63775,48766,01:03.775,00:48.766
johnny aberzel,8,1683203642,112654,01:52.654,52908,59746,00:52.908,00:59.746
AryeMorZ,65,1683392737,112729,01:52.729,65601,47128,01:05.601,00:47.128
E.vaturi,14,1683148665,112859,01:52.859,46637,66222,00:46.637,01:06.222
drdr3vil,62,1683363864,112908,01:52.908,45488,67420,00:45.488,01:07.420
Yoni Goldberg,15,1683228695,113071,01:53.071,64791,48280,01:04.791,00:48.280
E.vaturi,5,1683147497,113216,01:53.216,62574,50642,01:02.574,00:50.642
Dori_N,41,1683370276,113321,01:53.321,51572,61749,00:51.572,01:01.749
BrAiT_Man,19,1683294433,113332,01:53.332,54864,58468,00:54.864,00:58.468
DoronV,38,1683276872,113387,01:53.387,59468,53919,00:59.468,00:53.919
yossi7385,11,1683251816,113393,01:53.393,47482,65911,00:47.482,01:05.911
Idan M,19,1683397400,113396,01:53.396,57205,56191,00:57.205,00:56.191
Y.Cohen,42,1683365903,113416,01:53.416,67687,45729,01:07.687,00:45.729
drdr3vil,4,1683212553,113513,01:53.513,63505,50008,01:03.505,00:50.008
drdr3vil,53,1683362555,113539,01:53.539,52361,61178,00:52.361,01:01.178
Etz,86,1683364130,113669,01:53.669,57338,56331,00:57.338,00:56.331
Y.Cohen,1,1683313844,113725,01:53.725,66174,47551,01:06.174,00:47.551
MarkZubarev,4,1683379020,113775,01:53.775,67069,46706,01:07.069,00:46.706
TAL S,59,1683403495,113856,01:53.856,42805,71051,00:42.805,01:11.051
Etz,132,1683397927,113910,01:53.910,66133,47777,01:06.133,00:47.777
OmriF,289,1683394974,114142,01:54.142,43622,70520,00:43.622,01:10.520
IMRACING R9,10,1683401797,114209,01:54.209,64502,49707,01:04.502,00:49.707
Etz,25,1683297147,114222,01:54.222,48782,65440,00:48.782,01:05.440
yossi7385,13,1683252026,114555,01:54.555,46199,68356,00:46.199,01:08.356
yossi7385,18,1683277248,114596,01:54.596,61281,53315,01:01.281,00:53.315
IMRACING R9,35,1683405890,114809,01:54.809,54415,60394,00:54.415,01:00.394
Boris Fr,121,1683365466,114824,01:54.824,65496,49328,01:05.496,00:49.328
OmriF,296,1683395647,114898,01:54.898,43541,71357,00:43.541,01:11.357
Jonathan Gutman,17,1683312211,114901,01:54.901,66026,48875,01:06.026,00:48.875
AryeMorZ,4,1683276729,114979,01:54.979,50273,64706,00:50.273,01:04.706
OmriF,198,1683380338,115037,01:55.037,43937,71100,00:43.937,01:11.100
Jonathan Gutman,4,1683310681,115090,01:55.090,64253,50837,01:04.253,00:50.837
ohad,4,1683274967,115095,01:55.095,45371,69724,00:45.371,01:09.724
assaf_itz,1,1683230658,115188,01:55.188,68468,46720,01:08.468,00:46.720
THE GM,29,1683365384,115344,01:55.344,58995,56349,00:58.995,00:56.349
assaf_itz,52,1683377382,115432,01:55.432,69662,45770,01:09.662,00:45.770
Elad Levy,27,1683292620,115649,01:55.649,68112,47537,01:08.112,00:47.537
AryeMorZ,3,1683276614,115677,01:55.677,59710,55967,00:59.710,00:55.967
Jonathan Gutman,35,1683362063,115715,01:55.715,45147,70568,00:45.147,01:10.568
OmriF,237,1683386049,115885,01:55.885,43277,72608,00:43.277,01:12.608
OmriF,68,1683233898,115912,01:55.912,61304,54608,01:01.304,00:54.608
OmriF,279,1683393358,115912,01:55.912,67222,48690,01:07.222,00:48.690
Idan M,1,1683394107,115931,01:55.931,60492,55439,01:00.492,00:55.439
OmriF,276,1683392587,115962,01:55.962,43318,72644,00:43.318,01:12.644
serbansim,21,1683365025,116164,01:56.164,68981,47183,01:08.981,00:47.183
OmriF,49,1683148116,116297,01:56.297,48878,67419,00:48.878,01:07.419
THE GM,2,1683283109,116349,01:56.349,56579,59770,00:56.579,00:59.770
assaf_itz,41,1683375809,116419,01:56.419,68125,48294,01:08.125,00:48.294
Boris Fr,86,1683235600,116521,01:56.521,65784,50737,01:05.784,00:50.737
drdr3vil,58,1683363466,116703,01:56.703,55534,61169,00:55.534,01:01.169
Boris Fr,54,1683223185,116724,01:56.724,68654,48070,01:08.654,00:48.070
E.vaturi,46,1683275998,116834,01:56.834,45528,71306,00:45.528,01:11.306
Etz,78,1683362725,116884,01:56.884,45555,71329,00:45.555,01:11.329
Ori Arish,13,1683147808,117133,01:57.133,45578,71555,00:45.578,01:11.555
Ido,44,1683390427,117235,01:57.235,70628,46607,01:10.628,00:46.607
serbansim,22,1683365143,117262,01:57.262,68630,48632,01:08.630,00:48.632
Etz,34,1683300528,117271,01:57.271,65764,51507,01:05.764,00:51.507
OneLeg,6,1683321922,117527,01:57.527,43845,73682,00:43.845,01:13.682
Elad Levy,10,1683290206,117549,01:57.549,70420,47129,01:10.420,00:47.129
YTS01,41,1683387251,117572,01:57.572,44839,72733,00:44.839,01:12.733
drdr3vil,12,1683214426,117599,01:57.599,67208,50391,01:07.208,00:50.391
THE GM,34,1683390437,117658,01:57.658,57205,60453,00:57.205,01:00.453
e30misha,11,1683152478,117811,01:57.811,65300,52511,01:05.300,00:52.511
Etz,47,1683314500,117880,01:57.880,69275,48605,01:09.275,00:48.605
THE GM,41,1683391357,117899,01:57.899,56497,61402,00:56.497,01:01.402
Etz,121,1683395941,117922,01:57.922,53950,63972,00:53.950,01:03.972
avieinav,1,1683402393,117960,01:57.960,65606,52354,01:05.606,00:52.354
Landzer,37,1683187738,118068,01:58.068,68991,49077,01:08.991,00:49.077
THE GM,30,1683365503,118259,01:58.259,48671,69588,00:48.671,01:09.588
AryeMorZ,48,1683387777,118269,01:58.269,45341,72928,00:45.341,01:12.928
IMRACING R9,20,1683402842,118416,01:58.416,47054,71362,00:47.054,01:11.362
yarin levi,34,1683365657,118483,01:58.483,68380,50103,01:08.380,00:50.103
OmriF,265,1683389380,118495,01:58.495,55360,63135,00:55.360,01:03.135
Jonathan Gutman,21,1683360594,118865,01:58.865,52940,65925,00:52.940,01:05.925
Ori Arish,1,1683146415,118945,01:58.945,65174,53771,01:05.174,00:53.771
Ido,62,1683393248,119105,01:59.105,43285,75820,00:43.285,01:15.820
AryeMorZ,47,1683387659,119124,01:59.124,44838,74286,00:44.838,01:14.286
THE GM,20,1683363980,119126,01:59.126,53678,65448,00:53.678,01:05.448
BrAiT_Man,11,1683292524,119199,01:59.199,60581,58618,01:00.581,00:58.618
ShimiC,3,1683382839,119377,01:59.377,65562,53815,01:05.562,00:53.815
TAL S,26,1683394864,119708,01:59.708,73210,46498,01:13.210,00:46.498
Elad Levy,33,1683299000,119714,01:59.714,55148,64566,00:55.148,01:04.566
OmriF,189,1683302459,119768,01:59.768,43570,76198,00:43.570,01:16.198
Boris Fr,43,1683222003,119799,01:59.799,44383,75416,00:44.383,01:15.416
Etz,57,1683315917,119917,01:59.917,48047,71870,00:48.047,01:11.870
Jonathan Gutman,24,1683360915,120187,02:00.187,58483,61704,00:58.483,01:01.704
YTS01,7,1683298502,120216,02:00.216,61630,58586,01:01.630,00:58.586
DoronV,22,1683240693,120574,02:00.574,65219,55355,01:05.219,00:55.355
Jonathan Gutman,12,1683311714,120621,02:00.621,72376,48245,01:12.376,00:48.245
johnny aberzel,4,1683203177,120642,02:00.642,50455,70187,00:50.455,01:10.187
Landzer,86,1683362587,120781,02:00.781,69540,51241,01:09.540,00:51.241
yarimalk23,1,1683299318,120812,02:00.812,70556,50256,01:10.556,00:50.256
YTS01,8,1683298623,120919,02:00.919,45607,75312,00:45.607,01:15.312
Michael Simon,1,1683228703,120954,02:00.954,73650,47304,01:13.650,00:47.304
ohad,8,1683275411,121098,02:01.098,72659,48439,01:12.659,00:48.439
OmriF,330,1683399831,121230,02:01.230,71369,49861,01:11.369,00:49.861
drdr3vil,1,1683212171,121317,02:01.317,64977,56340,01:04.977,00:56.340
assaf_itz,68,1683379266,121340,02:01.340,75193,46147,01:15.193,00:46.147
OmriF,249,1683387816,121357,02:01.357,68180,53177,01:08.180,00:53.177
Etz,135,1683398416,121455,02:01.455,68885,52570,01:08.885,00:52.570
OmriF,355,1683404314,121771,02:01.771,62942,58829,01:02.942,00:58.829
OmriF,163,1683294888,121806,02:01.806,70411,51395,01:10.411,00:51.395
Ido,75,1683395224,121915,02:01.915,42819,79096,00:42.819,01:19.096
DoronV,39,1683276994,121935,02:01.935,73902,48033,01:13.902,00:48.033
Jonathan Gutman,20,1683360475,122012,02:02.012,72954,49058,01:12.954,00:49.058
Etz,12,1683278483,122021,02:02.021,58068,63953,00:58.068,01:03.953
IMRACING R9,44,1683406784,122071,02:02.071,44662,77409,00:44.662,01:17.409
AryeMorZ,73,1683399350,122113,02:02.113,74534,47579,01:14.534,00:47.579
THE GM,19,1683363860,122204,02:02.204,64794,57410,01:04.794,00:57.410
OmriF,270,1683389866,122216,02:02.216,75120,47096,01:15.120,00:47.096
AryeMorZ,23,1683289045,122309,02:02.309,42453,79856,00:42.453,01:19.856
DoronV,33,1683242202,122322,02:02.322,73771,48551,01:13.771,00:48.551
OmriF,283,1683393752,122352,02:02.352,50360,71992,00:50.360,01:11.992
Etz,95,1683366364,122492,02:02.492,53584,68908,00:53.584,01:08.908
drdr3vil,48,1683362054,122500,02:02.500,68050,54450,01:08.050,00:54.450
ElioR_Alkobi,6,1683308023,122531,02:02.531,72739,49792,01:12.739,00:49.792
Ido,24,1683148123,122581,02:02.581,66326,56255,01:06.326,00:56.255
Sagy,2,1683299834,122739,02:02.739,67771,54968,01:07.771,00:54.968
OmriF,371,1683406147,122834,02:02.834,74950,47884,01:14.950,00:47.884
Dori_N,11,1683319251,122866,02:02.866,65172,57694,01:05.172,00:57.694
Ori Arish,18,1683148665,123136,02:03.136,62935,60201,01:02.935,01:00.201
e30misha,54,1683216241,123168,02:03.168,74945,48223,01:14.945,00:48.223
drdr3vil,21,1683217682,123193,02:03.193,74494,48699,01:14.494,00:48.699
ormik_pok,1,1683142047,123319,02:03.319,68199,55120,01:08.199,00:55.120
THE GM,4,1683283337,123366,02:03.366,73924,49442,01:13.924,00:49.442
Elad Levy,8,1683289999,123489,02:03.489,77148,46341,01:17.148,00:46.341
THE GM,31,1683389902,123504,02:03.504,69976,53528,01:09.976,00:53.528
Elad Levy,67,1683405778,123678,02:03.678,65146,58532,01:05.146,00:58.532
OmriF,169,1683297385,123697,02:03.697,69895,53802,01:09.895,00:53.802
Etz,52,1683315338,124068,02:04.068,51856,72212,00:51.856,01:12.212
leviarnon1,6,1683403251,124224,02:04.224,72073,52151,01:12.073,00:52.151
AryeMorZ,5,1683276853,124291,02:04.291,44025,80266,00:44.025,01:20.266
assaf_itz,67,1683379145,124373,02:04.373,77529,46844,01:17.529,00:46.844
Ido,1,1683144482,124394,02:04.394,74206,50188,01:14.206,00:50.188
OmriF,188,1683302339,124426,02:04.426,75579,48847,01:15.579,00:48.847
Crazy,23,1683391178,124479,02:04.479,78007,46472,01:18.007,00:46.472
assaf_itz,63,1683378449,124628,02:04.628,78674,45954,01:18.674,00:45.954
drdr3vil,22,1683217807,124664,02:04.664,44664,80000,00:44.664,01
OmriF,107,1683238270,124787,02:04.787,77619,47168,01:17.619,00:47.168
Landzer,76,1683305727,124961,02:04.961,77828,47133,01:17.828,00:47.133
Dori_N,59,1683382017,125168,02:05.168,74881,50287,01:14.881,00:50.287
Elad Levy,31,1683293032,125353,02:05.353,79170,46183,01:19.170,00:46.183
assaf_itz,13,1683232789,125448,02:05.448,79048,46400,01:19.048,00:46.400
drdr3vil,9,1683213833,125662,02:05.662,75870,49792,01:15.870,00:49.792
drdr3vil,17,1683215172,125673,02:05.673,44907,80766,00:44.907,01:20.766
Corrado_Kid_VR,7,1683291694,125887,02:05.887,77616,48271,01:17.616,00:48.271
THE GM,18,1683363738,125894,02:05.894,64001,61893,01:04.001,01:01.893
drdr3vil,20,1683217526,126132,02:06.132,58888,67244,00:58.888,01:07.244
OmriF,132,1683241526,126140,02:06.140,78224,47916,01:18.224,00:47.916
OmriF,114,1683238947,126389,02:06.389,42928,83461,00:42.928,01:23.461
Boris Fr,22,1683148127,126609,02:06.609,56084,70525,00:56.084,01:10.525
drdr3vil,24,1683297760,126654,02:06.654,73581,53073,01:13.581,00:53.073
assaf_itz,43,1683376024,126727,02:06.727,80382,46345,01:20.382,00:46.345
U.V,7,1683219841,126795,02:06.795,43374,83421,00:43.374,01:23.421
Y.Cohen,4,1683314151,126877,02:06.877,80621,46256,01:20.621,00:46.256
serbansim,34,1683381510,127036,02:07.036,59378,67658,00:59.378,01:07.658
Boris Fr,165,1683399356,127317,02:07.317,42892,84425,00:42.892,01:24.425
Dori_N,16,1683319819,127504,02:07.504,81294,46210,01:21.294,00:46.210
Yoni Goldberg,1,1683225980,127716,02:07.716,69882,57834,01:09.882,00:57.834
serbansim,10,1683286655,127869,02:07.869,67686,60183,01:07.686,01:00.183
drdr3vil,33,1683298890,127904,02:07.904,67411,60493,01:07.411,01:00.493
OmriF,119,1683239472,128074,02:08.074,68107,59967,01:08.107,00:59.967
Elad Levy,73,1683406471,128273,02:08.273,80996,47277,01:20.996,00:47.277
SHAKED,7,1683228474,128429,02:08.429,43739,84690,00:43.739,01:24.690
yossi7385,5,1683251209,128463,02:08.463,75200,53263,01:15.200,00:53.263
OmriF,56,1683148849,128464,02:08.464,80467,47997,01:20.467,00:47.997
drdr3vil,15,1683214950,128490,02:08.490,63915,64575,01:03.915,01:04.575
Etz,56,1683315797,128494,02:08.494,45852,82642,00:45.852,01:22.642
yarin levi,74,1683389331,128713,02:08.713,82214,46499,01:22.214,00:46.499
OneLeg,1,1683321316,128845,02:08.845,75128,53717,01:15.128,00:53.717
e30misha,15,1683181611,128933,02:08.933,56371,72562,00:56.371,01:12.562
OmriF,121,1683240168,129030,02:09.030,57695,71335,00:57.695,01:11.335
Etz,38,1683300971,129443,02:09.443,77397,52046,01:17.397,00:52.046
SirSiriuSoWhy,22,1683366588,129887,02:09.887,83614,46273,01:23.614,00:46.273
BrAiT_Man,13,1683292958,129894,02:09.894,67946,61948,01:07.946,01:01.948
THE GM,12,1683288184,130078,02:10.078,45073,85005,00:45.073,01:25.005
assaf_itz,5,1683231211,130107,02:10.107,83545,46562,01:23.545,00:46.562
IMRACING R9,4,1683400879,130154,02:10.154,59329,70825,00:59.329,01:10.825
ohad,2,1683274753,130348,02:10.348,49155,81193,00:49.155,01:21.193
Hublot,6,1683402765,130654,02:10.654,77468,53186,01:17.468,00:53.186
E.vaturi,37,1683233412,130854,02:10.854,45174,85680,00:45.174,01:25.680
OmriF,364,1683405218,130879,02:10.879,43075,87804,00:43.075,01:27.804
SirSiriuSoWhy,2,1683143433,131174,02:11.174,83367,47807,01:23.367,00:47.807
yossi7385,26,1683278448,131234,02:11.234,81451,49783,01:21.451,00:49.783
U.V,28,1683230459,131492,02:11.492,65590,65902,01:05.590,01:05.902
drdr3vil,39,1683300058,131508,02:11.508,59472,72036,00:59.472,01:12.036
Jonathan Gutman,26,1683361160,131700,02:11.700,45664,86036,00:45.664,01:26.036
OmriF,255,1683388412,131787,02:11.787,43303,88484,00:43.303,01:28.484
Boris Fr,1,1683144310,131829,02:11.829,82284,49545,01:22.284,00:49.545
drdr3vil,29,1683298417,131829,02:11.829,68811,63018,01:08.811,01:03.018
Crazy,28,1683391669,131919,02:11.919,84412,47507,01:24.412,00:47.507
Etz,54,1683315573,131959,02:11.959,61584,70375,01:01.584,01:10.375
drdr3vil,38,1683299829,132265,02:12.265,83381,48884,01:23.381,00:48.884
MarkZubarev,1,1683378119,132341,02:12.341,83786,48555,01:23.786,00:48.555
ohad,5,1683275099,132399,02:12.399,80405,51994,01:20.405,00:51.994
Sagy,1,1683299508,132526,02:12.526,83993,48533,01:23.993,00:48.533
OmriF,157,1683293998,132614,02:12.614,44747,87867,00:44.747,01:27.867
ShimiC,4,1683382972,132652,02:12.652,85091,47561,01:25.091,00:47.561
Elad Levy,39,1683299643,132731,02:12.731,86750,45981,01:26.750,00:45.981
Etz,61,1683317179,132775,02:12.775,81245,51530,01:21.245,00:51.530
Ido,63,1683393381,132933,02:12.933,43270,89663,00:43.270,01:29.663
E.vaturi,41,1683275484,132981,02:12.981,75543,57438,01:15.543,00:57.438
drdr3vil,36,1683299464,133394,02:13.394,68289,65105,01:08.289,01:05.105
OmriF,147,1683293002,133673,02:13.673,85924,47749,01:25.924,00:47.749
Etz,58,1683316051,133710,02:13.710,50869,82841,00:50.869,01:22.841
OmriF,1,1683141851,134002,02:14.002,84876,49126,01:24.876,00:49.126
drdr3vil,5,1683212753,134191,02:14.191,83453,50738,01:23.453,00:50.738
YTS01,27,1683356492,134491,02:14.491,72166,62325,01:12.166,01:02.325
OmriF,238,1683386184,134587,02:14.587,74206,60381,01:14.206,01:00.381
U.V,37,1683281775,134673,02:14.673,88485,46188,01:28.485,00:46.188
DoronV,59,1683284115,134985,02:14.985,86889,48096,01:26.889,00:48.096
THE GM,13,1683288689,135361,02:15.361,63739,71622,01:03.739,01:11.622
IMRACING R9,2,1683400643,135519,02:15.519,57241,78278,00:57.241,01:18.278
OneLeg,9,1683322636,135554,02:15.554,72730,62824,01:12.730,01:02.824
Ido,85,1683396609,135832,02:15.832,42389,93443,00:42.389,01:33.443
ShimiC,5,1683383107,135914,02:15.914,86874,49040,01:26.874,00:49.040
chachacha,61,1683333747,135972,02:15.972,88037,47935,01:28.037,00:47.935
OmriF,22,1683144847,136068,02:16.068,88475,47593,01:28.475,00:47.593
Etz,42,1683313682,136068,02:16.068,73103,62965,01:13.103,01:02.965
OmriF,32,1683146018,136544,02:16.544,52710,83834,00:52.710,01:23.834
Elad Levy,21,1683291730,136549,02:16.549,89646,46903,01:29.646,00:46.903
YTS01,24,1683356088,136682,02:16.682,87065,49617,01:27.065,00:49.617
EDF Tomer Gulak,1,1683227892,136819,02:16.819,87760,49059,01:27.760,00:49.059
TAL S,62,1683403813,136938,02:16.938,84836,52102,01:24.836,00:52.102
Dori_N,29,1683369109,136939,02:16.939,42610,94329,00:42.610,01:34.329
Elad Levy,13,1683290526,137127,02:17.127,90479,46648,01:30.479,00:46.648
serbansim,15,1683287157,137219,02:17.219,88921,48298,01:28.921,00:48.298
Ori Arish,3,1683146646,137507,02:17.507,90118,47389,01:30.118,00:47.389
Dori_N,71,1683384354,137693,02:17.693,88761,48932,01:28.761,00:48.932
assaf_itz,30,1683235200,137877,02:17.877,89870,48007,01:29.870,00:48.007
U.V,1,1683219202,138169,02:18.169,84309,53860,01:24.309,00:53.860
Elad Levy,53,1683301312,138230,02:18.230,91736,46494,01:31.736,00:46.494
A972K,1,1683404533,139078,02:19.078,89753,49325,01:29.753,00:49.325
Landzer,89,1683362919,139207,02:19.207,91853,47354,01:31.853,00:47.354
OmriF,333,1683400173,139503,02:19.503,43468,96035,00:43.468,01:36.035
johnny aberzel,3,1683203056,139846,02:19.846,84802,55044,01:24.802,00:55.044
Etz,59,1683316191,139904,02:19.904,90971,48933,01:30.971,00:48.933
Yuval Rosen,58,1683396914,140315,02:20.315,85514,54801,01:25.514,00:54.801
yarin levi,30,1683365244,140485,02:20.485,93599,46886,01:33.599,00:46.886
OmriF,166,1683295215,140984,02:20.984,52150,88834,00:52.150,01:28.834
OmriF,53,1683148539,141200,02:21.200,51714,89486,00:51.714,01:29.486
Jonathan Gutman,9,1683311313,141459,02:21.459,86693,54766,01:26.693,00:54.766
YTS01,5,1683298286,141548,02:21.548,91576,49972,01:31.576,00:49.972
Boris Fr,10,1683145510,141688,02:21.688,91846,49842,01:31.846,00:49.842
SirSiriuSoWhy,23,1683366730,141717,02:21.717,94268,47449,01:34.268,00:47.449
KirilikBot,13,1683269866,141775,02:21.775,87217,54558,01:27.217,00:54.558
assaf_itz,37,1683375367,141998,02:21.998,94379,47619,01:34.379,00:47.619
E.vaturi,59,1683401449,142115,02:22.115,45680,96435,00:45.680,01:36.435
chachacha,20,1683235465,142278,02:22.278,92841,49437,01:32.841,00:49.437
johnny aberzel,5,1683203319,142352,02:22.352,89531,52821,01:29.531,00:52.821
Boris Fr,15,1683146899,142430,02:22.430,79223,63207,01:19.223,01:03.207
assaf_itz,57,1683377881,143220,02:23.220,97373,45847,01:37.373,00:45.847
OmriF,319,1683398685,143411,02:23.411,82904,60507,01:22.904,01:00.507
Y.Cohen,93,1683389673,143523,02:23.523,97604,45919,01:37.604,00:45.919
Y.Cohen,52,1683366846,143564,02:23.564,98123,45441,01:38.123,00:45.441
Boris Fr,11,1683145654,143614,02:23.614,94618,48996,01:34.618,00:48.996
chachacha,4,1683233747,143656,02:23.656,95389,48267,01:35.389,00:48.267
e30misha,46,1683215467,143735,02:23.735,94969,48766,01:34.969,00:48.766
Daniel Malka,1,1683195599,143951,02:23.951,91670,52281,01:31.670,00:52.281
itziksamurai1,1,1683207421,144271,02:24.271,84817,59454,01:24.817,00:59.454
serbansim,51,1683391758,144286,02:24.286,43279,101007,00:43.279,01:41.007
Hublot,1,1683401551,144379,02:24.379,72208,72171,01:12.208,01:12.171
E.vaturi,39,1683233652,144387,02:24.387,93339,51048,01:33.339,00:51.048
Or BMW,1,1683278935,144424,02:24.424,88566,55858,01:28.566,00:55.858
Or BMW,15,1683300366,144494,02:24.494,91462,53032,01:31.462,00:53.032
Boris Fr,112,1683297310,144510,02:24.510,97350,47160,01:37.350,00:47.160
THE GM,23,1683364334,145058,02:25.058,86460,58598,01:26.460,00:58.598
THE GM,16,1683363509,145104,02:25.104,56323,88781,00:56.323,01:28.781
Etz,90,1683364562,145229,02:25.229,97174,48055,01:37.174,00:48.055
Jonathan Gutman,18,1683360245,145238,02:25.238,97196,48042,01:37.196,00:48.042
Etz,5,1683149038,145466,02:25.466,86940,58526,01:26.940,00:58.526
Elad Levy,38,1683299510,146013,02:26.013,99780,46233,01:39.780,00:46.233
SirSiriuSoWhy,24,1683366876,146079,02:26.079,100107,45972,01:40.107,00:45.972
assaf_itz,40,1683375692,146463,02:26.463,100004,46459,01:40.004,00:46.459
TAL S,1,1683316554,146471,02:26.471,62349,84122,01:02.349,01:24.122
yarin levi,65,1683388283,146548,02:26.548,93794,52754,01:33.794,00:52.754
chachacha,27,1683330205,146733,02:26.733,99181,47552,01:39.181,00:47.552
OmriF,139,1683242230,146742,02:26.742,94672,52070,01:34.672,00:52.070
drdr3vil,37,1683299697,147061,02:27.061,68703,78358,01:08.703,01:18.358
Corrado_Kid_VR,1,1683291078,147722,02:27.722,95329,52393,01:35.329,00:52.393
DoronV,76,1683287464,147974,02:27.974,92382,55592,01:32.382,00:55.592
Boris Fr,93,1683291838,148654,02:28.654,62551,86103,01:02.551,01:26.103
Yuval Rosen,18,1683146811,149157,02:29.157,102068,47089,01:42.068,00:47.089
DoronV,63,1683285765,149504,02:29.504,101377,48127,01:41.377,00:48.127
assaf_itz,29,1683235062,149980,02:29.980,102608,47372,01:42.608,00:47.372
OmriF,246,1683387501,150014,02:30.014,101770,48244,01:41.770,00:48.244
TAL S,39,1683401391,150488,02:30.488,92034,58454,01:32.034,00:58.454
Boris Fr,107,1683296727,151219,02:31.219,52944,98275,00:52.944,01:38.275
leviarnon1,30,1683405618,151266,02:31.266,104029,47237,01:44.029,00:47.237
Elad Levy,22,1683291881,151696,02:31.696,106035,45661,01:46.035,00:45.661
DoronV,32,1683242080,151829,02:31.829,103581,48248,01:43.581,00:48.248
YTS01,38,1683386866,151884,02:31.884,92241,59643,01:32.241,00:59.643
assaf_itz,25,1683234562,152328,02:32.328,106153,46175,01:46.153,00:46.175
DoronV,82,1683315575,152379,02:32.379,103157,49222,01:43.157,00:49.222
assaf_itz,20,1683233667,152997,02:32.997,106790,46207,01:46.790,00:46.207
Dori_N,12,1683319404,153581,02:33.581,106277,47304,01:46.277,00:47.304
U.V,6,1683219714,154685,02:34.685,107926,46759,01:47.926,00:46.759
BrAiT_Man,1,1683290468,155417,02:35.417,66705,88712,01:06.705,01:28.712
yossi7385,37,1683279572,155588,02:35.588,107907,47681,01:47.907,00:47.681
Etz,120,1683395823,156099,02:36.099,44800,111299,00:44.800,01:51.299
Etz,115,1683395269,156630,02:36.630,45997,110633,00:45.997,01:50.633
TAL S,64,1683404077,157101,02:37.101,42463,114638,00:42.463,01:54.638
E.vaturi,4,1683147384,157429,02:37.429,90712,66717,01:30.712,01:06.717
Y.Cohen,112,1683391629,157722,02:37.722,110084,47638,01:50.084,00:47.638
Elad Levy,61,1683404866,157758,02:37.758,103825,53933,01:43.825,00:53.933
avieinav,7,1683403007,157835,02:37.835,43256,114579,00:43.256,01:54.579
ITZYuval,1,1683210477,157947,02:37.947,109144,48803,01:49.144,00:48.803
Ido,29,1683148642,159025,02:39.025,86521,72504,01:26.521,01:12.504
Boris Fr,44,1683222162,159295,02:39.295,111559,47736,01:51.559,00:47.736
Etz,22,1683296827,160007,02:40.007,106858,53149,01:46.858,00:53.149
itziksamurai1,4,1683207978,160290,02:40.290,112090,48200,01:52.090,00:48.200
yarin levi,83,1683391940,160881,02:40.881,63383,97498,01:03.383,01:37.498
drdr3vil,34,1683299106,160925,02:40.925,103879,57046,01:43.879,00:57.046
Boris Fr,108,1683296888,161141,02:41.141,112136,49005,01:52.136,00:49.005
IMRACING R16,14,1683402756,161463,02:41.463,114586,46877,01:54.586,00:46.877
Elad Levy,46,1683300621,161590,02:41.590,115672,45918,01:55.672,00:45.918
chachacha,24,1683237352,161988,02:41.988,113482,48506,01:53.482,00:48.506
ohad,1,1683274622,162118,02:42.118,107529,54589,01:47.529,00:54.589
drdr3vil,23,1683220830,162330,02:42.330,86676,75654,01:26.676,01:15.654
yarin levi,62,1683387942,162383,02:42.383,115899,46484,01:55.899,00:46.484
SHAKED,5,1683228247,162536,02:42.536,102331,60205,01:42.331,01:00.205
KirilikBot,12,1683269725,162806,02:42.806,115250,47556,01:55.250,00:47.556
Idan M,34,1683402757,163040,02:43.040,111552,51488,01:51.552,00:51.488
assaf_itz,24,1683234410,163154,02:43.154,117088,46066,01:57.088,00:46.066
tomerventura,11,1683392045,164147,02:44.147,117194,46953,01:57.194,00:46.953
THE GM,14,1683363146,164688,02:44.688,78099,86589,01:18.099,01:26.589
chachacha,7,1683234087,166122,02:46.122,108792,57330,01:48.792,00:57.330
AryeMorZ,55,1683388516,166247,02:46.247,117774,48473,01:57.774,00:48.473
Michael Simon,5,1683229248,166256,02:46.256,118584,47672,01:58.584,00:47.672
OmriF,99,1683237354,166857,02:46.857,115516,51341,01:55.516,00:51.341
Etz,60,1683317045,168107,02:48.107,117987,50120,01:57.987,00:50.120
Etz,76,1683362499,168589,02:48.589,113748,54841,01:53.748,00:54.841
Etz,29,1683298814,168674,02:48.674,104099,64575,01:44.099,01:04.575
AryeMorZ,1,1683276399,168810,02:48.810,119454,49356,01:59.454,00:49.356
Landzer,22,1683150378,169317,02:49.317,118381,50936,01:58.381,00:50.936
Etz,105,1683368017,170529,02:50.529,122783,47746,02:02.783,00:47.746
assaf_itz,31,1683235371,170599,02:50.599,124839,45760,02:04.839,00:45.760
assaf_itz,10,1683231837,171256,02:51.256,125334,45922,02:05.334,00:45.922
Y.Cohen,8,1683315155,171867,02:51.867,124806,47061,02:04.806,00:47.061
drdr3vil,6,1683213034,172229,02:52.229,119562,52667,01:59.562,00:52.667
Idan M,14,1683395797,172235,02:52.235,111463,60772,01:51.463,01:00.772
assaf_itz,76,1683380059,172402,02:52.402,126412,45990,02:06.412,00:45.990
BrAiT_Man,5,1683291378,172454,02:52.454,121064,51390,02:01.064,00:51.390
assaf_itz,27,1683234824,172649,02:52.649,125004,47645,02:05.004,00:47.645
Jonathan Gutman,10,1683311486,173078,02:53.078,114070,59008,01:54.070,00:59.008
OmriF,63,1683149863,173425,02:53.425,123628,49797,02:03.628,00:49.797
THE GM,40,1683391239,173847,02:53.847,122533,51314,02:02.533,00:51.314
Or BMW,2,1683279109,174097,02:54.097,114157,59940,01:54.157,00:59.940
Elad Levy,76,1683406822,174642,02:54.642,128607,46035,02:08.607,00:46.035
Dori_N,2,1683318180,174754,02:54.754,115286,59468,01:55.286,00:59.468
THE GM,25,1683364608,174923,02:54.923,121913,53010,02:01.913,00:53.010
Landzer,70,1683305135,174938,02:54.938,123251,51687,02:03.251,00:51.687
assaf_itz,46,1683376376,174950,02:54.950,128700,46250,02:08.700,00:46.250
GasCan13,20,1683384049,175110,02:55.110,130083,45027,02:10.083,00:45.027
Elad Levy,42,1683300193,175970,02:55.970,127776,48194,02:07.776,00:48.194
YTS01,26,1683356357,176061,02:56.061,127987,48074,02:07.987,00:48.074
assaf_itz,51,1683377266,176129,02:56.129,130436,45693,02:10.436,00:45.693
YTS01,40,1683387133,176185,02:56.185,120385,55800,02:00.385,00:55.800
Etz,68,1683361498,176236,02:56.236,106103,70133,01:46.103,01:10.133
chachacha,22,1683235729,176721,02:56.721,127950,48771,02:07.950,00:48.771
DoronV,7,1683204466,177006,02:57.006,128041,48965,02:08.041,00:48.965
E.vaturi,1,1683143139,177049,02:57.049,122819,54230,02:02.819,00:54.230
johnny aberzel,2,1683202917,177189,02:57.189,99887,77302,01:39.887,01:17.302
MarkZubarev,3,1683378654,177302,02:57.302,119644,57658,01:59.644,00:57.658
assaf_itz,19,1683233514,177562,02:57.562,127815,49747,02:07.815,00:49.747
yarin levi,84,1683392117,177632,02:57.632,130742,46890,02:10.742,00:46.890
Boris Fr,74,1683234459,177787,02:57.787,128184,49603,02:08.184,00:49.603
DoronV,78,1683315146,178160,02:58.160,129038,49122,02:09.038,00:49.122
Landzer,116,1683365640,178203,02:58.203,130516,47687,02:10.516,00:47.687
yossi7385,1,1683214914,178516,02:58.516,103996,74520,01:43.996,01:14.520
Etz,62,1683317358,178655,02:58.655,129605,49050,02:09.605,00:49.050
GasCan13,9,1683382993,178679,02:58.679,132798,45881,02:12.798,00:45.881
AryeMorZ,20,1683288717,178732,02:58.732,132629,46103,02:12.629,00:46.103
chachacha,10,1683234456,179722,02:59.722,132675,47047,02:12.675,00:47.047
SirSiriuSoWhy,1,1683143302,179880,02:59.880,131536,48344,02:11.536,00:48.344
assaf_itz,18,1683233336,179995,02:59.995,133712,46283,02:13.712,00:46.283
OmriF,19,1683143846,180184,03:00.184,132570,47614,02:12.570,00:47.614
Etz,64,1683317645,181205,03:01.205,90567,90638,01:30.567,01:30.638
DoronV,30,1683241836,182330,03:02.330,133901,48429,02:13.901,00:48.429
chachacha,31,1683330669,182338,03:02.338,134751,47587,02:14.751,00:47.587
Idan M,33,1683402594,182419,03:02.419,134634,47785,02:14.634,00:47.785
TAL S,30,1683395322,183128,03:03.128,135987,47141,02:15.987,00:47.141
Jonathan Gutman,1,1683310357,183412,03:03.412,116087,67325,01:56.087,01:07.325
yarimalk23,18,1683301124,183551,03:03.551,138146,45405,02:18.146,00:45.405
Etz,103,1683367656,183713,03:03.713,135104,48609,02:15.104,00:48.609
Elad Levy,3,1683289504,183905,03:03.905,130738,53167,02:10.738,00:53.167
IMRACING R16,10,1683402320,184537,03:04.537,137566,46971,02:17.566,00:46.971
Etz,113,1683395020,185522,03:05.522,137184,48338,02:17.184,00:48.338
AryeMorZ,46,1683387540,185559,03:05.559,136716,48843,02:16.716,00:48.843
chachacha,41,1683331664,185734,03:05.734,137750,47984,02:17.750,00:47.984
assaf_itz,6,1683231397,186781,03:06.781,139814,46967,02:19.814,00:46.967
SirSiriuSoWhy,11,1683299794,186952,03:06.952,139648,47304,02:19.648,00:47.304
Or BMW,10,1683299519,187566,03:07.566,137579,49987,02:17.579,00:49.987
OmriF,314,1683398009,187795,03:07.795,107987,79808,01:47.987,01:19.808
U.V,31,1683278614,188879,03:08.879,123144,65735,02:03.144,01:05.735
T.K,5,1683359962,189597,03:09.597,143764,45833,02:23.764,00:45.833
OmriF,326,1683399432,190752,03:10.752,44214,146538,00:44.214,02:26.538
Elad Levy,25,1683292249,191076,03:11.076,145184,45892,02:25.184,00:45.892
assaf_itz,22,1683234136,193932,03:13.932,147077,46855,02:27.077,00:46.855
Y.Cohen,57,1683367705,194369,03:14.369,148510,45859,02:28.510,00:45.859
YTS01,1,1683297852,194509,03:14.509,125492,69017,02:05.492,01:09.017
yarimalk23,21,1683301497,195124,03:15.124,149314,45810,02:29.314,00:45.810
THE GM,32,1683390098,196105,03:16.105,118628,77477,01:58.628,01:17.477
Boris Fr,13,1683146597,197166,03:17.166,147801,49365,02:27.801,00:49.365
Michael Simon,2,1683228901,197743,03:17.743,151083,46660,02:31.083,00:46.660
IMRACING R9,7,1683401286,200305,03:20.305,137039,63266,02:17.039,01:03.266
OmriF,186,1683302120,200954,03:20.954,152247,48707,02:32.247,00:48.707
DoronV,1,1683203819,201156,03:21.156,151484,49672,02:31.484,00:49.672
Yuval Rosen,54,1683207560,201190,03:21.190,145858,55332,02:25.858,00:55.332
Etz,66,1683361222,201848,03:21.848,149941,51907,02:29.941,00:51.907
DoronV,54,1683283379,202230,03:22.230,153922,48308,02:33.922,00:48.308
Or BMW,3,1683279312,202929,03:22.929,149441,53488,02:29.441,00:53.488
IMRACING R9,28,1683404992,203404,03:23.404,154215,49189,02:34.215,00:49.189
Elad Levy,19,1683291503,204717,03:24.717,158376,46341,02:38.376,00:46.341
Yuval Rosen,38,1683149069,205371,03:25.371,157049,48322,02:37.049,00:48.322
Boris Fr,91,1683236756,205642,03:25.642,153852,51790,02:33.852,00:51.790
OneLeg,4,1683321715,206076,03:26.076,159249,46827,02:39.249,00:46.827
Y.Cohen,21,1683316618,206512,03:26.512,160891,45621,02:40.891,00:45.621
chachacha,65,1683368264,208045,03:28.045,160872,47173,02:40.872,00:47.173
OmriF,84,1683235724,208292,03:28.292,161195,47097,02:41.195,00:47.097
Etz,3,1683148790,208758,03:28.758,108749,100009,01:48.749,01:40.009
Elad Levy,72,1683406343,208768,03:28.768,163142,45626,02:43.142,00:45.626
SirSiriuSoWhy,7,1683299336,208940,03:28.940,160543,48397,02:40.543,00:48.397
yarimalk23,47,1683325283,210612,03:30.612,151859,58753,02:31.859,00:58.753
Etz,124,1683396350,211610,03:31.610,163425,48185,02:43.425,00:48.185
yarin levi,48,1683368708,212477,03:32.477,165786,46691,02:45.786,00:46.691
YTS01,28,1683356705,213423,03:33.423,163045,50378,02:43.045,00:50.378
Landzer,3,1683148327,214009,03:34.009,162984,51025,02:42.984,00:51.025
IMRACING R9,1,1683400507,216424,03:36.424,152578,63846,02:32.578,01:03.846
DoronV,43,1683277637,217248,03:37.248,169349,47899,02:49.349,00:47.899
AryeMorZ,28,1683289619,217902,03:37.902,167011,50891,02:47.011,00:50.891
Crazy,12,1683390006,218924,03:38.924,171611,47313,02:51.611,00:47.313
Boris Fr,71,1683225221,219453,03:39.453,45748,173705,00:45.748,02:53.705
Y.Cohen,55,1683367422,219586,03:39.586,174050,45536,02:54.050,00:45.536
OmriF,201,1683380881,220646,03:40.646,170075,50571,02:50.075,00:50.571
Idan M,35,1683402977,220656,03:40.656,173167,47489,02:53.167,00:47.489
Etz,73,1683362137,222260,03:42.260,144806,77454,02:24.806,01:17.454
Michael Simon,7,1683229562,222571,03:42.571,174354,48217,02:54.354,00:48.217
Idan M,17,1683396198,222675,03:42.675,175253,47422,02:55.253,00:47.422
THE GM,38,1683390967,223117,03:43.117,170575,52542,02:50.575,00:52.542
Y.Cohen,32,1683317730,223124,03:43.124,168274,54850,02:48.274,00:54.850
chachacha,1,1683233427,223170,03:43.170,175699,47471,02:55.699,00:47.471
Yuval Rosen,35,1683148686,223497,03:43.497,174433,49064,02:54.433,00:49.064
Etz,46,1683314382,223565,03:43.565,159881,63684,02:39.881,01:03.684
Crazy,3,1683388645,223681,03:43.681,174753,48928,02:54.753,00:48.928
Crazy,7,1683389161,224892,03:44.892,174959,49933,02:54.959,00:49.933
OmriF,199,1683380563,224931,03:44.931,178459,46472,02:58.459,00:46.472
E.vaturi,17,1683228344,227346,03:47.346,145535,81811,02:25.535,01:21.811
U.V,40,1683282180,227942,03:47.942,171148,56794,02:51.148,00:56.794
Etz,19,1683296451,230401,03:50.401,165790,64611,02:45.790,01:04.611
Etz,27,1683298072,233038,03:53.038,183488,49550,03:03.488,00:49.550
Boris Fr,16,1683147133,233224,03:53.224,182442,50782,03:02.442,00:50.782
Etz,50,1683315115,234073,03:54.073,169386,64687,02:49.386,01:04.687
E.vaturi,32,1683232881,234118,03:54.118,182984,51134,03:02.984,00:51.134
Ori Arish,10,1683147487,234257,03:54.257,182687,51570,03:02.687,00:51.570
THE GM,28,1683365269,234285,03:54.285,54424,179861,00:54.424,02:59.861
OmriF,101,1683237680,234461,03:54.461,186996,47465,03:06.996,00:47.465
OmriF,46,1683147544,234825,03:54.825,183021,51804,03:03.021,00:51.804
Etz,2,1683148581,238385,03:58.385,183152,55233,03:03.152,00:55.233
Idan M,12,1683395534,238511,03:58.511,187373,51138,03:07.373,00:51.138
YTS01,11,1683299058,238951,03:58.951,190257,48694,03:10.257,00:48.694
Sagy,5,1683300364,240665,04:00.665,192921,47744,03:12.921,00:47.744
tomerventura,7,1683389779,242189,04:02.189,43937,198252,00:43.937,03:18.252
assaf_itz,2,1683230901,242720,04:02.720,196055,46665,03:16.055,00:46.665
ElioR_Alkobi,9,1683369452,242848,04:02.848,194522,48326,03:14.522,00:48.326
YTS01,12,1683299302,243069,04:03.069,178457,64612,02:58.457,01:04.612
EDF Tomer Gulak,4,1683228321,244738,04:04.738,197915,46823,03:17.915,00:46.823
SirSiriuSoWhy,26,1683367449,244789,04:04.789,198394,46395,03:18.394,00:46.395
Hublot,40,1683406467,245296,04:05.296,198537,46759,03:18.537,00:46.759
Dori_N,1,1683318005,246412,04:06.412,194302,52110,03:14.302,00:52.110
OmriF,318,1683398542,246451,04:06.451,195309,51142,03:15.309,00:51.142
Landzer,13,1683149445,247163,04:07.163,196232,50931,03:16.232,00:50.931
Landzer,53,1683229343,247245,04:07.245,199958,47287,03:19.958,00:47.287
OmriF,71,1683234341,248979,04:08.979,198983,49996,03:18.983,00:49.996
OmriF,349,1683403399,251418,04:11.418,94786,156632,01:34.786,02:36.632
U.V,20,1683228834,252020,04:12.020,203308,48712,03:23.308,00:48.712
DoronV,11,1683205412,252860,04:12.860,204463,48397,03:24.463,00:48.397
Ori Arish,14,1683148254,254110,04:14.110,185336,68774,03:05.336,01:08.774
T.K,1,1683359385,256204,04:16.204,207932,48272,03:27.932,00:48.272
DoronV,75,1683287316,257857,04:17.857,207597,50260,03:27.597,00:50.260
DoronV,77,1683287722,258086,04:18.086,209396,48690,03:29.396,00:48.690
Crazy,30,1683392017,259286,04:19.286,197438,61848,03:17.438,01:01.848
TAL S,71,1683405187,259970,04:19.970,212649,47321,03:32.649,00:47.321
OmriF,11,1683143002,259979,04:19.979,210399,49580,03:30.399,00:49.580
Boris Fr,147,1683397252,261267,04:21.267,212729,48538,03:32.729,00:48.538
yossi7385,41,1683280124,262269,04:22.269,213516,48753,03:33.516,00:48.753
Ido,53,1683391723,263909,04:23.909,216011,47898,03:36.011,00:47.898
Y.Cohen,78,1683388280,264034,04:24.034,218049,45985,03:38.049,00:45.985
E.vaturi,61,1683401995,265335,04:25.335,215682,49653,03:35.682,00:49.653
yarin levi,70,1683388917,266304,04:26.304,219485,46819,03:39.485,00:46.819
OmriF,28,1683145597,267480,04:27.480,215829,51651,03:35.829,00:51.651
Idan M,30,1683402227,268169,04:28.169,221167,47002,03:41.167,00:47.002
Etz,1,1683148340,268313,04:28.313,191786,76527,03:11.786,01:16.527
Etz,134,1683398295,270945,04:30.945,222794,48151,03:42.794,00:48.151
BrAiT_Man,14,1683293950,271000,04,223642,47358,03:43.642,00:47.358
Boris Fr,127,1683379231,274186,04:34.186,210709,63477,03:30.709,01:03.477
Etz,43,1683313958,274603,04:34.603,55368,219235,00:55.368,03:39.235
Ido,72,1683394900,274900,04:34.900,43146,231754,00:43.146,03:51.754
assaf_itz,21,1683233943,275715,04:35.715,229895,45820,03:49.895,00:45.820
Y.Cohen,12,1683315702,276339,04:36.339,229673,46666,03:49.673,00:46.666
tomerventura,25,1683393818,278574,04:38.574,215425,63149,03:35.425,01:03.149
OmriF,239,1683386791,280272,04:40.272,229795,50477,03:49.795,00:50.477
SHAKED,1,1683227783,280504,04:40.504,203473,77031,03:23.473,01:17.031
oyway1,1,1683220442,284667,04:44.667,236292,48375,03:56.292,00:48.375
Boris Fr,21,1683147808,285992,04:45.992,234837,51155,03:54.837,00:51.155
itziksamurai1,9,1683374340,287321,04:47.321,239365,47956,03:59.365,00:47.956
Etz,7,1683277466,288051,04:48.051,148478,139573,02:28.478,02:19.573
SirSiriuSoWhy,20,1683366368,288769,04:48.769,241861,46908,04:01.861,00:46.908
Etz,8,1683277762,294722,04:54.722,242275,52447,04:02.275,00:52.447
Hublot,16,1683403903,296475,04:56.475,237039,59436,03:57.039,00:59.436
itziksamurai1,2,1683207717,296641,04:56.641,232314,64327,03:52.314,01:04.327
assaf_itz,11,1683232574,298489,04:58.489,252481,46008,04:12.481,00:46.008
Ido,14,1683146257,303091,05:03.091,245320,57771,04:05.320,00:57.771
E.vaturi,19,1683228885,303296,05:03.296,249742,53554,04:09.742,00:53.554
ShimiC,1,1683297547,305187,05:05.187,256843,48344,04:16.843,00:48.344
OmriF,221,1683384510,313490,05:13.490,261565,51925,04:21.565,00:51.925
OneLeg,8,1683322328,316549,05:16.549,266414,50135,04:26.414,00:50.135
yarin levi,29,1683365103,316551,05:16.551,265984,50567,04:25.984,00:50.567
OmriF,182,1683301616,319001,05:19.001,254795,64206,04:14.795,01:04.206
yossi7385,22,1683277851,319967,05:19.967,268074,51893,04:28.074,00:51.893
ElioR_Alkobi,1,1683198238,320981,05:20.981,267945,53036,04:27.945,00:53.036
Landzer,50,1683228905,322898,05:22.898,223494,99404,03:43.494,01:39.404
DoronV,58,1683283980,323927,05:23.927,260257,63670,04:20.257,01:03.670
Idan M,10,1683395197,325757,05:25.757,278201,47556,04:38.201,00:47.556
Dori_N,20,1683368224,329262,05:29.262,282363,46899,04:42.363,00:46.899
Idan M,18,1683396531,332509,05:32.509,285335,47174,04:45.335,00:47.174
YTS01,35,1683386361,335138,05:35.138,281796,53342,04:41.796,00:53.342
E.vaturi,55,1683400465,335562,05:35.562,283285,52277,04:43.285,00:52.277
OmriF,273,1683392289,337784,05:37.784,289486,48298,04:49.486,00:48.298
yarin levi,42,1683366638,337861,05:37.861,269673,68188,04:29.673,01:08.188
IMRACING R16,1,1683400972,338153,05:38.153,290012,48141,04:50.012,00:48.141
yarin levi,1,1683313068,339936,05:39.936,165542,174394,02:45.542,02:54.394
Michael Simon,10,1683230086,342412,05:42.412,295387,47025,04:55.387,00:47.025
Crazy,10,1683389695,349067,05:49.067,299127,49940,04:59.127,00:49.940
DoronV,18,1683207368,352796,05:52.796,303989,48807,05:03.989,00:48.807
Ido,23,1683147835,356964,05:56.964,43507,313457,00:43.507,05:13.457
MarkZubarev,2,1683378477,357104,05:57.104,45317,311787,00:45.317,05:11.787
OmriF,61,1683149589,361846,06:01.846,314780,47066,05:14.780,00:47.066
OmriF,170,1683297747,362111,06:02.111,45230,316881,00:45.230,05:16.881
tomerventura,8,1683390141,362774,06:02.774,312127,50647,05:12.127,00:50.647
DoronV,68,1683286500,365083,06:05.083,316055,49028,05:16.055,00:49.028
Etz,6,1683149406,366554,06:06.554,312050,54504,05:12.050,00:54.504
tomerventura,14,1683392603,374739,06:14.739,325189,49550,05:25.189,00:49.550
TAL S,67,1683404650,375500,06:15.500,328845,46655,05:28.845,00:46.655
IMRACING R16,2,1683401347,375667,06:15.667,328808,46859,05:28.808,00:46.859
Idan M,22,1683400970,376686,06:16.686,329138,47548,05:29.138,00:47.548
Etz,82,1683363728,378677,06:18.677,327819,50858,05:27.819,00:50.858
Ido,48,1683391084,382942,06:22.942,43237,339705,00:43.237,05:39.705
Boris Fr,12,1683146400,383675,06:23.675,333001,50674,05:33.001,00:50.674
OmriF,159,1683294486,383731,06:23.731,331135,52596,05:31.135,00:52.596
OmriF,125,1683240835,391522,06:31.522,340901,50621,05:40.901,00:50.621
DoronV,25,1683241283,392032,06:32.032,343455,48577,05:43.455,00:48.577
Boris Fr,154,1683398314,393316,06:33.316,342443,50873,05:42.443,00:50.873
Landzer,1,1683147829,394934,06:34.934,343783,51151,05:43.783,00:51.151
Etz,11,1683278360,397773,06:37.773,346877,50896,05:46.877,00:50.896
Elad Levy,15,1683291021,400119,06:40.119,353588,46531,05:53.588,00:46.531
Ido,9,1683145564,407173,06:47.173,358627,48546,05:58.627,00:48.546
E.vaturi,56,1683401117,409838,06:49.838,304147,105691,05:04.147,01:45.691
yarin levi,60,1683387675,439089,07:19.089,391290,47799,06:31.290,00:47.799
assaf_itz,33,1683374597,440223,07:20.223,394390,45833,06:34.390,00:45.833
OmriF,335,1683400704,441188,07:21.188,385591,55597,06:25.591,00:55.597
Etz,13,1683278927,444220,07:24.220,392416,51804,06:32.416,00:51.804
assaf_itz,47,1683376824,447672,07:27.672,401277,46395,06:41.277,00:46.395
Ido,55,1683392280,465363,07:45.363,418085,47278,06:58.085,00:47.278
yarin levi,19,1683363927,473926,07:53.926,425313,48613,07:05.313,00:48.613
itziksamurai1,7,1683208633,474634,07:54.634,427978,46656,07:07.978,00:46.656
E.vaturi,62,1683403366,475386,07:55.386,424464,50922,07:04.464,00:50.922
Etz,32,1683299515,485884,08:05.884,436024,49860,07:16.024,00:49.860
Idan M,37,1683403562,494999,08:14.999,448186,46813,07:28.186,00:46.813
Ido,31,1683149240,508103,08:28.103,453410,54693,07:33.410,00:54.693
OmriF,311,1683397493,515746,08:35.746,442014,73732,07:22.014,01:13.732
Y.Cohen,6,1683314774,534271,08:54.271,479096,55175,07:59.096,00:55.175
Ido,18,1683147094,568364,09:28.364,513996,54368,08:33.996,00:54.368
OmriF,285,1683394588,595511,09:55.511,546605,48906,09:06.605,00:48.906
E.vaturi,53,1683399957,600553,10:00.553,550347,50206,09:10.347,00:50.206
U.V,12,1683221710,605790,10:05.790,559120,46670,09:19.120,00:46.670
Etz,109,1683368948,652976,10:52.976,605065,47911,10:05.065,00:47.911
U.V,9,1683220586,655801,10:55.801,596612,59189,09:56.612,00:59.189
Hublot,4,1683402536,656606,10:56.606,610207,46399,10:10.207,00:46.399
Etz,18,1683279985,675476,11:15.476,621621,53855,10:21.621,00:53.855
Etz,128,1683397352,721275,12:01.275,671675,49600,11:11.675,00:49.600
OmriF,141,1683292246,800438,13:20.438,753836,46602,12:33.836,00:46.602
Boris Fr,138,1683381133,871656,14:31.656,821958,49698,13:41.958,00:49.698
OmriF,342,1683402568,876376,14:36.376,829572,46804,13:49.572,00:46.804
U.V,26,1683230238,958179,15:58.179,911837,46342,15:11.837,00:46.342
Dori_N,65,1683383740,1102869,18:22.869,1048211,54658,17:28.211,00:54.658
IMRACING R9,24,1683404492,1341881,22:21.881,1281775,60106,21:21.775,01:00.106
Etz,94,1683366241,1392857,23:12.857,1344672,48185,22:24.672,00:48.185
AryeMorZ,68,1683395403,1412224,23:32.224,1359705,52519,22:39.705,00:52.519
U.V,35,1683280563,1682156,28:02.156,1636031,46125,27:16.031,00:46.125
MarkZubarev,9,1683381124,1744092,29:04.092,1697130,46962,28:17.130,00:46.962
AryeMorZ,13,1683283129,2127448,35:27.448,2072715,54733,34:32.715,00:54.733
AryeMorZ,62,1683392444,2150914,35:50.914,2103011,47903,35:03.011,00:47.903
Idan M,20,1683400494,2680988,44:40.988,2627668,53320,43:47.668,00:53.320
AryeMorZ,17,1683288174,3480424,58:00.424,3431743,48681,57:11.743,00:48.681
